Tanggal,Positif (Indonesia),Dirawat (Indonesia),Sembuh (Indonesia),Meninggal (Indonesia),Meninggal (Jakarta),Sembuh (Jakarta),Self-Isolation (Jakarta),Dirawat (Jakarta),Positif (Jakarta),Positif Aktif (Jakarta),Positif Harian (Indonesia),Dirawat Harian (Indonesia),Sembuh Harian (Indonesia),Meninggal Harian (Indonesia),Meninggal Harian (Jakarta),Sembuh Harian (Jakarta),Self-Isolation Harian (Jakarta),Dirawat Harian (Jakarta),Positif Harian (Jakarta),Positif Aktif Harian (Jakarta)
29/01/2020 ,0,0,0,0,0,0,0,0,0,0,0,0,0,0,0,0,0,0,0,0
01/03/2020 ,0,0,0,0,0,0,0,0,0,0,0,0,0,0,0,0,0,0,0,0
02/03/2020 ,2,2,0,0,0,0,0,0,0,0,2,2,0,0,0,0,0,0,0,0
03/03/2020 ,2,2,0,0,1,0,0,2,3,2,0,0,0,0,1,0,0,2,3,2
04/03/2020 ,2,2,0,0,1,0,0,2,3,2,0,0,0,0,0,0,0,0,0,0
05/03/2020 ,2,2,0,0,3,0,0,4,7,4,0,0,0,0,2,0,0,2,4,2
06/03/2020 ,4,4,0,0,3,0,0,4,7,4,2,2,0,0,0,0,0,0,0,0
07/03/2020 ,4,4,0,0,3,0,0,4,7,4,0,0,0,0,0,0,0,0,0,0
08/03/2020 ,6,6,0,0,3,0,0,4,7,4,2,2,0,0,0,0,0,0,0,0
09/03/2020 ,19,19,0,0,3,0,0,31,34,31,13,13,0,0,0,0,0,27,27,27
10/03/2020 ,27,25,2,0,3,0,0,31,34,31,8,6,2,0,0,0,0,0,0,0
11/03/2020 ,34,31,2,1,3,0,0,33,36,33,7,6,0,1,0,0,0,2,2,2
12/03/2020 ,34,31,2,1,5,0,0,57,62,57,0,0,0,0,2,0,0,24,26,24
13/03/2020 ,69,63,2,4,7,0,0,65,72,65,35,32,0,3,2,0,0,8,10,8
14/03/2020 ,96,83,8,5,9,0,0,70,79,70,27,20,6,1,2,0,0,5,7,5
15/03/2020 ,117,104,8,5,11,0,0,84,95,84,21,21,0,0,2,0,0,14,16,14
16/03/2020 ,134,121,8,5,12,0,7,78,97,85,17,17,0,0,1,0,7,-6,2,1
17/03/2020 ,172,158,9,5,12,0,27,83,122,110,38,37,1,0,0,0,20,5,25,25
18/03/2020 ,227,197,11,19,15,12,42,91,160,133,55,39,2,14,3,12,15,8,38,23
19/03/2020 ,309,269,15,25,19,13,57,121,210,178,82,72,4,6,4,1,15,30,50,45
20/03/2020 ,369,320,17,32,20,13,66,125,224,191,60,51,2,7,1,0,9,4,14,13
21/03/2020 ,450,392,20,38,23,17,71,157,268,228,81,72,3,6,3,4,5,32,44,37
22/03/2020 ,514,437,29,48,29,21,77,177,304,254,64,45,9,10,6,4,6,20,36,26
23/03/2020 ,579,500,30,49,29,22,79,225,355,304,65,63,1,1,0,1,2,48,51,50
24/03/2020 ,686,601,30,55,34,23,109,260,426,369,107,101,0,6,5,1,30,35,71,65
25/03/2020 ,790,701,31,58,43,27,112,290,472,402,104,100,1,3,9,4,3,30,46,33
26/03/2020 ,893,780,35,78,49,29,113,324,515,437,103,79,4,20,6,2,1,34,43,35
27/03/2020 ,1046,913,46,87,57,31,132,346,566,478,153,133,11,9,8,2,19,22,51,41
28/03/2020 ,1155,994,59,102,62,43,134,364,603,498,109,81,13,15,5,12,2,18,37,20
29/03/2020 ,1285,1107,64,114,67,48,151,435,701,586,130,113,5,12,5,5,17,71,98,88
30/03/2020 ,1414,1217,75,122,78,49,151,449,727,600,129,110,11,8,11,1,0,14,26,14
31/03/2020 ,1528,1311,81,136,84,49,157,451,741,608,114,94,6,14,6,0,6,2,14,8
01/04/2020 ,1677,1417,103,157,90,51,176,499,816,675,149,106,22,21,6,2,19,48,75,67
02/04/2020 ,1790,1508,112,170,95,54,195,565,909,760,113,91,9,13,5,3,19,66,93,85
03/04/2020 ,1986,1671,134,181,98,56,209,627,990,836,196,163,22,11,3,2,14,62,81,76
04/04/2020 ,2092,1751,150,191,99,58,223,691,1071,914,106,80,16,10,1,2,14,64,81,78
05/04/2020 ,2273,1911,164,198,123,64,279,685,1151,964,181,160,14,7,24,6,56,-6,80,50
06/04/2020 ,2491,2090,192,209,131,68,317,783,1299,1100,218,179,28,11,8,4,38,98,148,136
07/04/2020 ,2738,2313,204,221,141,69,338,895,1443,1233,247,223,12,12,10,1,21,112,144,133
08/04/2020 ,2956,2494,222,240,144,75,357,976,1552,1333,218,181,18,19,3,6,19,81,109,100
09/04/2020 ,3293,2761,252,280,155,82,405,1077,1719,1482,337,267,30,40,11,7,48,101,167,149
10/04/2020 ,3512,2924,282,306,156,82,433,1139,1810,1572,219,163,30,26,1,0,28,62,91,90
11/04/2020 ,3842,3229,286,327,168,142,441,1152,1903,1593,330,305,4,21,12,60,8,13,93,21
12/04/2020 ,4241,3509,359,373,195,142,468,1277,2082,1745,399,280,73,46,27,0,27,125,179,152
13/04/2020 ,4557,3778,380,399,209,142,521,1370,2242,1891,316,269,21,26,14,0,53,93,160,146
14/04/2020 ,4839,3954,426,459,243,163,558,1385,2349,1943,282,176,46,60,34,21,37,15,107,52
15/04/2020 ,5136,4221,446,469,246,164,613,1424,2447,2037,297,267,20,10,3,1,55,39,98,94
16/04/2020 ,5516,4472,548,496,248,202,619,1601,2670,2220,380,251,102,27,2,38,6,177,223,183
17/04/2020 ,5923,4796,607,520,250,203,643,1727,2823,2370,407,324,59,24,2,1,24,126,153,150
18/04/2020 ,6248,5082,631,535,257,206,670,1769,2902,2439,325,286,24,15,7,3,27,42,79,69
19/04/2020 ,6575,5307,686,582,292,207,695,1839,3033,2534,327,225,55,47,35,1,25,70,131,95
20/04/2020 ,6760,5423,747,590,297,237,752,1826,3112,2578,185,116,61,8,5,30,57,-13,79,44
21/04/2020 ,7135,5677,842,616,305,286,753,1935,3279,2688,375,254,95,26,8,49,1,109,167,110
22/04/2020 ,7418,5870,913,635,308,291,815,1985,3399,2800,283,193,71,19,3,5,62,50,120,112
23/04/2020 ,7775,6168,960,647,316,292,888,2010,3506,2898,357,298,47,12,8,1,73,25,107,98
24/04/2020 ,8211,6520,1002,689,331,327,959,1988,3605,2947,436,352,42,42,15,35,71,-22,99,49
25/04/2020 ,8607,6845,1042,720,350,334,1050,1947,3681,2997,396,325,40,31,19,7,91,-41,76,50
26/04/2020 ,8882,7032,1107,743,357,338,1099,1952,3746,3051,275,187,65,23,7,4,49,5,65,54
27/04/2020 ,9096,7180,1151,765,375,338,1169,1950,3832,3119,214,148,44,22,18,0,70,-2,86,68
28/04/2020 ,9511,7484,1254,773,379,341,1206,2024,3950,3230,415,304,103,8,4,3,37,74,118,111
29/04/2020 ,9771,7596,1391,784,381,412,1238,2002,4033,3240,260,112,137,11,2,71,32,-22,83,10
30/04/2020 ,10118,7804,1522,792,381,412,1272,2073,4138,3345,347,208,131,8,0,0,34,71,105,105
01/05/2020 ,10551,8160,1591,800,393,427,1312,2151,4283,3463,433,356,69,8,12,15,40,78,145,118
02/05/2020 ,10843,8347,1665,831,400,562,1304,2089,4355,3393,292,187,74,31,7,135,-8,-62,72,-70
03/05/2020 ,11192,8471,1876,845,410,622,1323,2062,4417,3385,349,124,211,14,10,60,19,-27,62,-8
04/05/2020 ,11587,8769,1954,864,412,650,1330,2080,4472,3410,395,298,78,19,2,28,7,18,55,25
05/05/2020 ,12071,9002,2197,872,414,711,1370,2146,4641,3516,484,233,243,8,2,61,40,66,169,106
06/05/2020 ,12438,9226,2317,895,420,713,1381,2195,4709,3576,367,224,120,23,6,2,11,49,68,60
07/05/2020 ,12776,9465,2381,930,430,718,1431,2196,4775,3627,338,239,64,35,10,5,50,1,66,51
08/05/2020 ,13112,9675,2494,943,431,763,1426,2281,4901,3707,336,210,113,13,1,45,-5,85,126,80
09/05/2020 ,13645,10079,2607,959,437,767,1442,2312,4958,3754,533,404,113,16,6,4,16,31,57,47
10/05/2020 ,14032,10361,2698,973,444,803,1533,2360,5140,3893,387,282,91,14,7,36,91,48,182,139
11/05/2020 ,14265,10393,2881,991,453,836,1648,2258,5195,3906,233,32,183,18,9,33,115,-102,55,13
12/05/2020 ,14749,10679,3063,1007,457,1262,1741,1843,5303,3584,484,286,182,16,4,426,93,-415,108,-322
13/05/2020 ,15438,11123,3287,1028,461,1277,1866,1833,5437,3699,689,444,224,21,4,15,125,-10,134,115
14/05/2020 ,16006,11445,3518,1043,466,1279,1995,1877,5617,3872,568,322,231,15,5,2,129,44,180,173
15/05/2020 ,16496,11617,3803,1076,474,1286,2019,1900,5679,3919,490,172,285,33,8,7,24,23,62,47
16/05/2020 ,17025,12025,3911,1089,475,1292,2120,1908,5795,4028,529,408,108,13,1,6,101,8,116,109
17/05/2020 ,17514,12237,4129,1148,478,1295,2217,1932,5922,4149,489,212,218,59,3,3,97,24,127,121
18/05/2020 ,18010,12495,4324,1191,483,1301,2266,1946,5996,4212,496,258,195,43,5,6,49,14,74,63
19/05/2020 ,18496,12808,4467,1221,487,1417,2213,1936,6053,4149,486,313,143,30,4,116,-53,-10,57,-63
20/05/2020 ,19189,13372,4575,1242,493,1425,2263,1969,6150,4232,693,564,108,21,6,8,50,33,97,83
21/05/2020 ,20162,14046,4838,1278,498,1536,2231,1955,6220,4186,973,674,263,36,5,111,-32,-14,70,-46
22/05/2020 ,20796,14413,5057,1326,501,1558,2282,1975,6316,4257,634,367,219,48,3,22,51,20,96,71
23/05/2020 ,21745,15145,5249,1351,504,1587,2346,2006,6443,4352,949,732,192,25,3,29,64,31,127,95
24/05/2020 ,22271,15497,5402,1372,505,1594,2431,2031,6561,4462,526,352,153,21,1,7,85,25,118,110
25/05/2020 ,22750,15717,5642,1391,506,1648,2430,2044,6628,4474,479,220,240,19,1,54,-1,13,67,12
26/05/2020 ,23165,15870,5877,1418,508,1678,2459,2044,6689,4503,415,153,235,27,2,30,29,0,61,29
27/05/2020 ,23851,16321,6057,1473,510,1698,2584,2034,6826,4618,686,451,180,55,2,20,125,-10,137,115
28/05/2020 ,24538,16802,6240,1496,514,1719,2641,2055,6929,4696,687,481,183,23,4,21,57,21,103,78
29/05/2020 ,25216,17204,6492,1520,517,1807,2722,2007,7053,4729,678,402,252,24,3,88,81,-48,124,33
30/05/2020 ,25773,17185,7015,1573,519,2003,2781,1848,7151,4629,557,-19,523,53,2,196,59,-159,98,-100
31/05/2020 ,26473,17552,7308,1613,520,2102,2827,1823,7272,4650,700,367,293,40,1,99,46,-25,121,21
01/06/2020 ,26940,17662,7637,1641,521,2246,2822,1794,7383,4616,467,110,329,28,1,144,-5,-29,111,-34
02/06/2020 ,27549,17951,7935,1663,525,2405,2786,1743,7459,4529,609,289,298,22,4,159,-36,-51,76,-87
03/06/2020 ,28233,18129,8406,1698,529,2534,2777,1699,7539,4476,684,178,471,35,4,129,-9,-44,80,-53
04/06/2020 ,28818,18205,8892,1721,530,2607,2793,1670,7600,4463,585,76,486,23,1,73,16,-29,61,-13
05/06/2020 ,29521,18308,9443,1770,532,2751,2768,1633,7684,4401,703,103,551,49,2,144,-25,-37,84,-62
06/06/2020 ,30514,18806,9907,1801,535,2840,2776,1635,7786,4411,993,498,464,31,3,89,8,2,102,10
07/06/2020 ,31186,18837,10498,1851,537,3170,2794,1445,7946,4239,672,31,591,50,2,330,18,-190,160,-172
08/06/2020 ,32033,19246,10904,1883,538,3205,2846,1448,8037,4294,847,409,406,32,1,35,52,3,91,55
09/06/2020 ,33076,19739,11414,1923,547,3369,2918,1442,8276,4360,1043,493,510,40,9,164,72,-6,239,66
10/06/2020 ,34316,20228,12129,1959,551,3517,2928,1427,8423,4355,1240,489,715,36,4,148,10,-15,147,-5
11/06/2020 ,35295,20659,12636,2000,555,3664,2887,1446,8552,4333,979,431,507,41,4,147,-41,19,129,-22
12/06/2020 ,36406,21145,13213,2048,561,3780,2863,1424,8628,4287,1111,486,577,48,6,116,-24,-22,76,-46
13/06/2020 ,37420,21553,13776,2091,564,3840,2925,1419,8748,4344,1014,408,563,43,3,60,62,-5,120,57
14/06/2020 ,38277,21612,14531,2134,571,4091,2833,1368,8863,4201,857,59,755,43,7,251,-92,-51,115,-143
15/06/2020 ,39294,21973,15123,2198,580,4198,2800,1390,8968,4190,1017,361,592,64,9,107,-33,22,105,-11
16/06/2020 ,40400,22466,15703,2231,583,4329,2764,1416,9092,4180,1106,493,580,33,3,131,-36,26,124,-10
17/06/2020 ,41431,22912,16243,2276,588,4444,2775,1402,9209,4177,1031,446,540,45,5,115,11,-14,117,-3
18/06/2020 ,42762,23625,16798,2339,594,4592,2822,1377,9385,4199,1331,713,555,63,6,148,47,-25,176,22
19/06/2020 ,43803,24081,17349,2373,599,4682,2862,1382,9525,4244,1041,456,551,34,5,90,40,5,140,45
20/06/2020 ,45029,24717,17883,2429,603,4821,2939,1340,9703,4279,1226,636,534,56,4,139,77,-42,178,35
21/06/2020 ,45891,25022,18404,2465,615,5054,2874,1287,9830,4161,862,305,521,36,12,233,-65,-53,127,-118
22/06/2020 ,46845,25610,18735,2500,618,5128,2901,1310,9957,4211,954,588,331,35,3,74,27,23,127,50
23/06/2020 ,47896,26120,19241,2535,619,5228,2957,1319,10123,4276,1051,510,506,35,1,100,56,9,166,65
24/06/2020 ,49009,26778,19658,2573,628,5322,2978,1349,10277,4327,1113,658,417,38,9,94,21,30,154,51
25/06/2020 ,50187,27118,20449,2620,631,5435,3068,1338,10472,4406,1178,340,791,47,3,113,90,-11,195,79
26/06/2020 ,51427,27411,21333,2683,632,5542,3136,1330,10640,4466,1240,293,884,63,1,107,68,-8,168,60
27/06/2020 ,52812,28183,21909,2720,632,5610,3256,1355,10853,4611,1385,772,576,37,0,68,120,25,213,145
28/06/2020 ,54010,28320,22936,2754,635,5865,3163,1322,10985,4485,1198,137,1027,34,3,255,-93,-33,132,-126
29/06/2020 ,55092,28487,23800,2805,636,6118,3299,1027,11080,4326,1082,167,864,51,1,253,136,-295,95,-159
30/06/2020 ,56385,28703,24806,2876,641,6512,3172,951,11276,4123,1293,216,1006,71,5,394,-127,-76,196,-203
01/07/2020 ,57770,29241,25595,2934,644,6680,3269,889,11482,4158,1385,538,789,58,3,168,97,-62,206,35
02/07/2020 ,59394,29740,26667,2987,646,6871,3356,804,11677,4160,1624,499,1072,53,2,191,87,-85,195,2
03/07/2020 ,60695,30091,27568,3036,648,7109,3331,736,11824,4067,1301,351,901,49,2,238,-25,-68,147,-93
04/07/2020 ,62142,30834,28219,3089,650,7377,3366,646,12039,4012,1447,743,651,53,2,268,35,-90,215,-55
05/07/2020 ,63749,31473,29105,3171,658,7663,3390,584,12295,3974,1607,639,886,82,8,286,24,-62,256,-38
06/07/2020 ,64958,31798,29919,3241,658,8033,3340,495,12526,3835,1209,325,814,70,0,370,-50,-89,231,-139
07/07/2020 ,66226,32132,30785,3309,664,8277,3379,405,12725,3784,1268,334,866,68,6,244,39,-90,199,-51
08/07/2020 ,68079,33135,31585,3359,667,8429,3556,417,13069,3973,1853,1003,800,50,3,152,177,12,344,189
09/07/2020 ,70736,34668,32651,3417,677,8647,3584,451,13359,4035,2657,1533,1066,58,10,218,28,34,290,62
10/07/2020 ,72347,35349,33529,3469,684,8825,3613,476,13598,4089,1611,681,878,52,7,178,29,25,239,54
11/07/2020 ,74018,35764,34719,3535,690,9040,3732,495,13957,4227,1671,415,1190,66,6,215,119,19,359,138
12/07/2020 ,75699,36455,35638,3606,702,9200,3905,554,14361,4459,1681,691,919,71,12,160,173,59,404,232
13/07/2020 ,76981,36636,36689,3656,710,9408,3924,597,14639,4521,1282,181,1051,50,8,208,19,43,278,62
14/07/2020 ,78572,37226,37636,3710,714,9528,4053,619,14914,4672,1591,590,947,54,4,120,129,22,275,151
15/07/2020 ,80094,37247,39050,3797,720,9721,4041,691,15173,4732,1522,21,1414,87,6,193,-12,72,259,60
16/07/2020 ,81668,37450,40345,3873,722,9857,4110,777,15466,4887,1574,203,1295,76,2,136,69,86,293,155
17/07/2020 ,83130,37339,41834,3957,731,9994,4156,826,15707,4982,1462,-111,1489,84,9,137,46,49,241,95
18/07/2020 ,84882,37598,43268,4016,740,10117,4289,892,16038,5181,1752,259,1434,59,9,123,133,66,331,199
19/07/2020 ,86521,36977,45401,4143,748,10444,4236,923,16351,5159,1639,-621,2133,127,8,327,-53,31,313,-22
20/07/2020 ,88214,36998,46977,4239,749,10602,4335,1026,16712,5361,1693,21,1576,96,1,158,99,103,361,202
21/07/2020 ,89869,37083,48466,4320,758,10864,4458,1073,17153,5531,1655,85,1489,81,9,262,123,47,441,170
22/07/2020 ,91751,37037,50255,4459,766,11187,4383,1193,17529,5576,1882,-46,1789,139,8,323,-75,120,376,45
23/07/2020 ,93657,36917,52164,4576,767,11302,4675,1201,17945,5876,1906,-120,1909,117,1,115,292,8,416,300
24/07/2020 ,95418,36808,53945,4665,768,11585,4577,1300,18230,5877,1761,-109,1781,89,1,283,-98,99,285,1
25/07/2020 ,97286,37218,55354,4714,769,11715,4729,1410,18623,6139,1868,410,1409,49,1,130,152,110,393,262
26/07/2020 ,98778,37342,56655,4781,779,11889,4842,1491,19001,6333,1492,124,1301,67,10,174,113,81,378,194
27/07/2020 ,100303,37292,58173,4838,782,11996,4993,1702,19473,6695,1525,-50,1518,57,3,107,151,211,472,362
28/07/2020 ,102051,36611,60539,4901,795,12373,4869,1848,19885,6717,1748,-681,2366,63,13,377,-124,146,412,22
29/07/2020 ,104432,37319,62138,4975,820,12613,5093,1944,20470,7037,2381,708,1599,74,25,240,224,96,585,320
30/07/2020 ,106336,36986,64292,5058,821,12801,5098,2049,20769,7147,1904,-333,2154,83,1,188,5,105,299,110
31/07/2020 ,108376,37338,65907,5131,836,13208,4974,2183,21201,7157,2040,352,1615,73,15,407,-124,134,432,10
01/08/2020 ,109936,36824,67919,5193,852,13887,4683,2153,21575,6836,1560,-514,2012,62,16,679,-291,-30,374,-321
02/08/2020 ,111455,37244,68975,5236,852,14027,4916,2159,21954,7075,1519,420,1056,43,0,140,233,6,379,239
03/08/2020 ,113134,37595,70237,5302,867,14165,5084,2327,22443,7411,1679,351,1262,66,15,138,168,168,489,336
04/08/2020 ,115056,37618,72050,5388,880,14381,5216,2432,22909,7648,1922,23,1813,86,13,216,132,105,466,237
05/08/2020 ,116871,37530,73889,5452,895,14760,5128,2483,23266,7611,1815,-88,1839,64,15,379,-88,51,357,-37
06/08/2020 ,118753,37587,75645,5521,908,15006,5397,2552,23863,7949,1882,57,1756,69,13,246,269,69,597,338
07/08/2020 ,121226,38076,77557,5593,922,15201,5803,2595,24521,8398,2473,489,1912,72,14,195,406,43,658,449
08/08/2020 ,123503,38539,79306,5658,934,15710,6110,2488,25242,8598,2277,463,1749,65,12,509,307,-107,721,200
09/08/2020 ,125396,38721,80952,5723,939,16268,6091,2416,25714,8507,1893,182,1646,65,5,558,-19,-72,472,-91
10/08/2020 ,127083,39082,82236,5765,940,16446,6252,2555,26193,8807,1687,361,1284,42,1,178,161,139,479,300
11/08/2020 ,128776,39242,83710,5824,953,16927,6236,2548,26664,8784,1693,160,1474,59,13,481,-16,-7,471,-23
12/08/2020 ,130718,39017,85798,5903,968,17349,6208,2717,27242,8925,1942,-225,2088,79,15,422,-28,169,578,141
13/08/2020 ,132816,39290,87558,5968,981,17838,6330,2714,27863,9044,2098,273,1760,65,13,489,122,-3,621,119
14/08/2020 ,135123,39484,89618,6021,985,18528,6331,2594,28438,8925,2307,194,2060,53,4,690,1,-120,575,-119
15/08/2020 ,137468,40076,91321,6071,991,18974,6457,2614,29036,9071,2345,592,1703,50,6,446,126,20,598,146
16/08/2020 ,139549,40296,93103,6150,995,19708,6284,2567,29554,8851,2081,220,1782,79,4,734,-173,-47,518,-220
17/08/2020 ,141370,40705,94458,6207,1011,19916,6514,2651,30092,9165,1821,409,1355,57,16,208,230,84,538,314
18/08/2020 ,143043,40460,96306,6277,1028,20505,6602,2462,30597,9064,1673,-245,1848,70,17,589,88,-189,505,-101
19/08/2020 ,144945,39942,98657,6346,1046,21069,6488,2559,31162,9047,1902,-518,2351,69,18,564,-114,97,565,-17
20/08/2020 ,147211,40119,100674,6418,1061,21795,6357,2544,31757,8901,2266,177,2017,72,15,726,-131,-15,595,-146
21/08/2020 ,149408,39917,102991,6500,1076,22228,6518,2576,32398,9094,2197,-202,2317,82,15,433,161,32,641,193
22/08/2020 ,151498,39706,105198,6594,1091,22877,6269,2762,32999,9031,2090,-211,2207,94,15,649,-249,186,601,-63
23/08/2020 ,153535,39355,107500,6680,1107,23567,6040,2922,33636,8962,2037,-351,2302,86,16,690,-229,160,637,-69
24/08/2020 ,155412,37593,111060,6759,1112,25463,5090,2630,34295,7720,1877,-1762,3560,79,5,1896,-950,-292,659,-1242
25/08/2020 ,157859,38134,112867,6858,1129,25986,5130,2686,34931,7816,2447,541,1807,99,17,523,40,56,636,96
26/08/2020 ,160165,37812,115409,6944,1144,26750,4978,2770,35642,7748,2306,-322,2542,86,15,764,-152,84,711,-68
27/08/2020 ,162884,37245,118575,7064,1147,28288,4499,2528,36462,7027,2719,-567,3166,120,3,1538,-479,-242,820,-721
28/08/2020 ,165887,37818,120900,7169,1154,29169,4128,2827,37278,6955,3003,573,2325,105,7,881,-371,299,816,-72
29/08/2020 ,169195,39132,122802,7261,1172,29768,4414,2812,38166,7226,3308,1314,1902,92,18,599,286,-15,888,271
30/08/2020 ,172053,40525,124185,7343,1186,30134,4945,3015,39280,7960,2858,1393,1383,82,14,366,531,203,1114,734
31/08/2020 ,174796,41420,125959,7417,1202,30538,5281,3288,40309,8569,2743,895,1774,74,16,404,336,273,1029,609
01/09/2020 ,177571,42009,128057,7505,1219,31267,5423,3341,41250,8764,2775,589,2098,88,17,729,142,53,941,195
02/09/2020 ,180646,43059,129971,7616,1237,31741,5757,3568,42303,9325,3075,1050,1914,111,18,474,334,227,1053,561
03/09/2020 ,184268,44463,132055,7750,1253,32424,6323,3709,43709,10032,3622,1404,2084,134,16,683,566,141,1406,707
04/09/2020 ,187537,45524,134181,7832,1260,33260,6257,3827,44604,10084,3269,1061,2126,82,7,836,-66,118,895,52
05/09/2020 ,190665,46324,136401,7940,1277,33991,6501,3677,45446,10178,3128,800,2220,108,17,731,244,-150,842,94
06/09/2020 ,194109,47509,138575,8025,1289,34738,6582,4082,46691,10664,3444,1185,2174,85,12,747,81,405,1245,486
07/09/2020 ,196989,48207,140652,8130,1318,35431,6706,4341,47796,11047,2880,698,2077,105,29,693,124,259,1105,383
08/09/2020 ,200035,48847,142958,8230,1330,36451,6598,4432,48811,11030,3046,640,2306,100,12,1020,-108,91,1015,-17
09/09/2020 ,203342,49806,145200,8336,1347,37245,6691,4554,49837,11245,3307,959,2242,106,17,794,93,122,1026,215
10/09/2020 ,207203,51237,147510,8456,1365,38226,6968,4728,51287,11696,3861,1431,2310,120,18,981,277,174,1450,451
11/09/2020 ,210940,52179,150217,8544,1382,39115,7143,4681,52321,11824,3737,942,2707,88,17,889,175,-47,1034,128
12/09/2020 ,214746,53638,152458,8650,1404,40183,7490,4684,53761,12174,3806,1459,2241,106,22,1068,347,3,1440,350
13/09/2020 ,218382,54649,155010,8723,1410,41014,7791,4649,54864,12440,3636,1011,2552,73,6,831,301,-35,1103,266
14/09/2020 ,221523,54277,158405,8841,1440,42325,7530,4631,55926,12161,3141,-372,3395,118,30,1311,-261,-18,1062,-279
15/09/2020 ,225030,55000,161065,8965,1468,43306,7711,4468,56953,12179,3507,723,2660,124,28,981,181,-163,1027,18
16/09/2020 ,228993,55792,164101,9100,1498,44251,7907,4802,58458,12709,3963,792,3036,135,30,945,196,334,1505,530
17/09/2020 ,232628,56720,166686,9222,1513,45207,8013,4739,59472,12752,3635,928,2585,122,15,956,106,-63,1014,43
18/09/2020 ,236519,56409,170774,9336,1535,46235,8450,4655,60875,13105,3891,-311,4088,114,22,1028,437,-84,1403,353
19/09/2020 ,240687,56889,174350,9448,1546,47260,8696,4305,61807,13001,4168,480,3576,112,11,1025,246,-350,932,-104
20/09/2020 ,244676,57796,177327,9553,1561,49209,8297,3819,62886,12116,3989,907,2977,105,15,1949,-399,-486,1079,-885
21/09/2020 ,248852,58378,180797,9677,1592,49630,9225,3749,64196,12974,4176,582,3470,124,31,421,928,-70,1310,858
22/09/2020 ,252923,58788,184298,9837,1624,50473,9380,3841,65318,13221,4071,410,3501,160,32,843,155,92,1122,247
23/09/2020 ,257388,59453,187958,9977,1650,51578,9611,3666,66505,13277,4465,665,3660,140,26,1105,231,-175,1187,56
24/09/2020 ,262022,60064,191853,10105,1664,52742,9714,3518,67638,13232,4634,611,3895,128,14,1164,103,-148,1133,-45
25/09/2020 ,266845,60431,196196,10218,1677,54352,10027,2871,68927,12898,4823,367,4343,113,13,1610,313,-647,1289,-334
26/09/2020 ,271339,61628,199403,10308,1679,55350,10594,2561,70184,13155,4494,1197,3207,90,2,998,567,-310,1257,257
27/09/2020 ,275213,61813,203014,10386,1692,56413,10915,2350,71370,13265,3874,185,3611,78,13,1063,321,-211,1186,110
28/09/2020 ,278722,61379,206870,10473,1704,57741,10474,2258,72177,12732,3509,-434,3856,87,12,1328,-441,-92,807,-533
29/09/2020 ,282724,61686,210437,10601,1718,58865,10659,2067,73309,12726,4002,307,3567,128,14,1124,185,-191,1132,-6
30/09/2020 ,287008,61321,214947,10740,1731,60320,10353,1964,74368,12317,4284,-365,4510,139,13,1455,-306,-103,1059,-409
01/10/2020 ,291182,61839,218487,10856,1737,61444,10545,1795,75521,12340,4174,518,3540,116,6,1124,192,-169,1153,23
02/10/2020 ,295499,63187,221340,10972,1740,62279,10496,2104,76619,12600,4317,1348,2853,116,3,835,-49,309,1098,260
03/10/2020 ,299506,63399,225052,11055,1743,63286,10652,2103,77784,12755,4007,212,3712,83,3,1007,156,-1,1165,155
04/10/2020 ,303498,63894,228453,11151,1761,64319,11091,2043,79214,13134,3992,495,3401,96,18,1033,439,-60,1430,379
05/10/2020 ,307120,63274,232593,11253,1772,65295,10912,2057,80036,12969,3622,-620,4140,102,11,976,-179,14,822,-165
06/10/2020 ,311176,63365,236437,11374,1806,66315,10787,2135,81043,12922,4056,91,3844,121,34,1020,-125,78,1007,-47
07/10/2020 ,315714,63951,240291,11472,1819,67310,10807,2447,82383,13254,4538,586,3854,98,13,995,20,312,1340,332
08/10/2020 ,320564,64924,244060,11580,1838,68352,10717,2485,83392,13202,4850,973,3769,108,19,1042,-90,38,1009,-52
09/10/2020 ,324658,65314,247667,11677,1860,69203,10746,2555,84364,13301,4094,390,3607,97,22,851,29,70,972,99
10/10/2020 ,328952,65706,251481,11765,1877,70487,10698,2555,85617,13253,4294,392,3814,88,17,1284,-48,0,1253,-48
11/10/2020 ,333449,66578,255027,11844,1901,71549,10863,2693,87006,13556,4497,872,3546,79,24,1062,165,138,1389,303
12/10/2020 ,336716,66262,258519,11935,1922,72633,10814,2805,88174,13619,3267,-316,3492,91,21,1084,-49,112,1168,63
13/10/2020 ,340622,65299,263296,12027,1944,73733,10908,2643,89228,13551,3906,-963,4777,92,22,1100,94,-162,1054,-68
14/10/2020 ,344749,64742,267851,12156,1961,74924,10822,2559,90266,13381,4127,-557,4555,129,17,1191,-86,-84,1038,-170
15/10/2020 ,349160,63231,273661,12268,1984,75974,10636,2743,91337,13379,4411,-1511,5810,112,23,1050,-186,184,1071,-2
16/10/2020 ,353461,63570,277544,12347,2008,76956,10498,2920,92382,13418,4301,339,3883,79,24,982,-138,177,1045,39
17/10/2020 ,357762,63739,281592,12431,2032,78062,10591,2671,93356,13262,4301,169,4048,84,24,1106,93,-249,974,-156
18/10/2020 ,361867,64032,285324,12511,2051,79136,10782,2358,94327,13140,4105,293,3732,80,19,1074,191,-313,971,-122
19/10/2020 ,365240,63380,289243,12617,2064,80261,10325,2603,95253,12928,3373,-652,3919,106,13,1125,-457,245,926,-212
20/10/2020 ,368842,62455,293653,12734,2086,81107,10292,2732,96217,13024,3602,-925,4410,117,22,846,-33,129,964,96
21/10/2020 ,373109,62743,297509,12857,2105,82178,10273,2661,97217,12934,4267,288,3856,123,19,1071,-19,-71,1000,-90
22/10/2020 ,377541,63576,301006,12959,2120,83338,9980,2768,98206,12748,4432,833,3497,102,15,1160,-293,107,989,-186
23/10/2020 ,381910,63733,305100,13077,2138,84430,9604,2986,99158,12590,4369,157,4094,118,18,1092,-376,218,952,-158
24/10/2020 ,385980,63556,309219,13205,2153,85586,9557,2924,100220,12481,4070,-177,4119,128,15,1156,-47,-62,1062,-109
25/10/2020 ,389712,62649,313764,13299,2164,86815,9151,2861,100991,12012,3732,-907,4545,94,11,1229,-406,-63,771,-469
26/10/2020 ,392934,61851,317672,13411,2185,87977,8960,2775,101897,11735,3222,-798,3908,112,21,1162,-191,-86,906,-277
27/10/2020 ,396454,60694,322248,13512,2195,89060,8743,2680,102678,11423,3520,-1157,4576,101,10,1083,-217,-95,781,-312
28/10/2020 ,400483,61078,325793,13612,2211,90157,8438,2716,103522,11154,4029,384,3545,100,16,1097,-305,36,844,-269
29/10/2020 ,404048,60569,329778,13701,2225,91235,7951,2824,104235,10775,3565,-509,3985,89,14,1078,-487,108,713,-379
30/10/2020 ,406945,58868,334295,13782,2239,92312,7457,2839,104847,10296,2897,-1701,4517,81,14,1077,-494,15,612,-479
31/10/2020 ,410088,58418,337801,13869,2255,94434,6524,2384,105597,8908,3143,-450,3506,87,16,2122,-933,-455,750,-1388
01/11/2020 ,412784,56899,341942,13943,2273,94819,6935,2178,106205,9113,2696,-1519,4141,74,18,385,411,-206,608,205
02/11/2020 ,415402,55792,345566,14044,2291,95876,7312,1750,107229,9062,2618,-1107,3624,101,18,1057,377,-428,1024,-51
03/11/2020 ,418375,54732,349497,14146,2300,96902,6844,1800,107846,8644,2973,-1060,3931,102,9,1026,-468,50,617,-418
04/11/2020 ,421731,54190,353282,14259,2315,97833,6665,1807,108620,8472,3356,-542,3785,113,15,931,-179,7,774,-172
05/11/2020 ,425796,54306,357142,14348,2331,98806,6260,2014,109411,8274,4065,116,3860,89,16,973,-405,207,791,-198
06/11/2020 ,429574,54427,360705,14442,2348,99830,6050,1855,110083,7905,3778,121,3563,94,17,1024,-210,-159,672,-369
07/11/2020 ,433836,54879,364417,14540,2359,100816,6159,1867,111201,8026,4262,452,3712,98,11,986,109,12,1118,121
08/11/2020 ,437716,54804,368298,14614,2366,101791,6338,1532,112027,7870,3880,-75,3881,74,7,975,179,-335,826,-156
09/11/2020 ,440569,53614,372266,14689,2377,102844,6050,1472,112743,7522,2853,-1190,3968,75,11,1053,-288,-60,716,-348
10/11/2020 ,444348,53846,375741,14761,2391,104144,5724,1497,113756,7221,3779,232,3475,72,14,1300,-326,25,1013,-301
11/11/2020 ,448118,54300,378982,14836,2403,105117,5161,1662,114343,6823,3770,454,3241,75,12,973,-563,165,587,-398
12/11/2020 ,452291,55274,382084,14933,2414,106189,4878,1693,115174,6571,4173,974,3102,97,11,1072,-283,31,831,-252
13/11/2020 ,457735,57604,385094,15037,2428,107147,5028,1604,116207,6632,5444,2330,3010,104,14,958,150,-89,1033,61
14/11/2020 ,463007,59765,388094,15148,2441,108209,4710,2102,117462,6812,5272,2161,3000,111,13,1062,-318,498,1255,180
15/11/2020 ,467113,59911,391991,15211,2448,109181,4952,2046,118627,6998,4106,146,3897,63,7,972,242,-56,1165,186
16/11/2020 ,470648,59909,395443,15296,2455,110221,4420,2537,119633,6957,3535,-2,3452,85,7,1040,-532,491,1006,-41
17/11/2020 ,474455,60426,398636,15393,2459,111096,4355,2761,120671,7116,3807,517,3193,97,4,875,-65,224,1038,159
18/11/2020 ,478720,60870,402347,15503,2470,111948,4619,2781,121818,7400,4265,444,3711,110,11,852,264,20,1147,284
19/11/2020 ,483518,61306,406612,15600,2484,112833,4633,3053,123003,7686,4798,436,4265,97,14,885,14,272,1185,286
20/11/2020 ,488310,62080,410552,15678,2501,113739,4616,3387,124243,8003,4792,774,3940,78,17,906,-17,334,1240,317
21/11/2020 ,493308,63579,413955,15774,2515,114863,5323,3121,125822,8444,4998,1499,3403,96,14,1124,707,-266,1579,441
22/11/2020 ,497668,63596,418188,15884,2531,115939,5529,3165,127164,8694,4360,17,4233,110,16,1076,206,44,1342,250
23/11/2020 ,502110,63722,422386,16002,2548,117003,5592,3030,128173,8622,4442,126,4198,118,17,1064,63,-135,1009,-72
24/11/2020 ,506302,64878,425313,16111,2567,118062,5518,3041,129188,8559,4192,1156,2927,109,19,1059,-74,11,1015,-63
25/11/2020 ,511836,65804,429807,16225,2584,119099,6000,2778,130461,8778,5534,926,4494,114,17,1037,482,-263,1273,219
26/11/2020 ,516753,66752,433649,16352,2597,120287,5876,2765,131525,8641,4917,948,3842,127,13,1188,-124,-13,1064,-137
27/11/2020 ,522581,68604,437456,16521,2614,121082,6653,2612,132961,9265,5828,1852,3807,169,17,795,777,-153,1436,624
28/11/2020 ,527999,69370,441983,16646,2632,122328,6921,2450,134331,9371,5418,766,4527,125,18,1246,268,-162,1370,106
29/11/2020 ,534266,71658,445793,16815,2652,123163,7608,2339,135762,9947,6267,2288,3810,169,20,835,687,-111,1431,576
30/11/2020 ,538883,71420,450518,16945,2671,124078,7823,2289,136861,10112,4617,-238,4725,130,19,915,215,-50,1099,165
01/12/2020 ,543975,72015,454879,17081,2689,125102,7937,2191,137919,10128,5092,595,4361,136,18,1024,114,-98,1058,16
02/12/2020 ,549508,73429,458880,17199,2710,126163,8202,2010,139085,10212,5533,1414,4001,118,21,1061,265,-181,1166,84
03/12/2020 ,557877,77969,462553,17355,2734,127136,8155,2213,140238,10368,8369,4540,3673,156,24,973,-47,203,1153,156
04/12/2020 ,563680,80023,466178,17479,2757,128051,8073,2389,141270,10462,5803,2054,3625,124,23,915,-82,176,1032,94
05/12/2020 ,569707,81669,470449,17589,2779,129067,8623,2161,142630,10784,6027,1646,4271,110,22,1016,550,-228,1360,322
06/12/2020 ,575796,83285,474771,17740,2799,130136,8819,2207,143961,11026,6089,1616,4322,151,20,1069,196,46,1331,242
07/12/2020 ,581550,84481,479202,17867,2823,131071,9473,2060,145427,11533,5754,1196,4431,127,24,935,654,-147,1466,507
08/12/2020 ,586842,85345,483497,18000,2842,132248,9650,1861,146601,11511,5292,864,4295,133,19,1177,177,-199,1174,-22
09/12/2020 ,592900,87284,487445,18171,2860,133318,9703,1957,147838,11660,6058,1939,3948,171,18,1070,53,96,1237,149
10/12/2020 ,598933,88622,491975,18336,2880,134366,9391,2381,149018,11772,6033,1338,4530,165,20,1048,-312,424,1180,112
11/12/2020 ,605243,89846,496886,18511,2902,135545,9078,2725,150250,11803,6310,1224,4911,175,22,1179,-313,344,1232,31
12/12/2020 ,611631,91602,501376,18653,2922,136489,8822,2968,151201,11790,6388,1756,4490,142,20,944,-256,243,951,-13
13/12/2020 ,617820,93165,505836,18819,2941,137605,8679,3274,152499,11953,6189,1563,4460,166,19,1116,-143,306,1298,163
14/12/2020 ,623309,93396,510957,18956,2963,138988,8994,3120,154065,12114,5489,231,5121,137,22,1383,315,-154,1566,161
15/12/2020 ,629429,93662,516656,19111,2990,140225,8643,3264,155122,11907,6120,266,5699,155,27,1237,-351,144,1057,-207
16/12/2020 ,636154,94922,521984,19248,3010,141365,8263,3705,156343,11968,6725,1260,5328,137,20,1140,-380,441,1221,61
17/12/2020 ,643508,97139,526979,19390,3027,142741,7851,4414,158033,12265,7354,2217,4995,142,17,1376,-412,709,1690,297
18/12/2020 ,650197,98688,531995,19514,3048,143959,7673,4940,159620,12613,6689,1549,5016,124,21,1218,-178,526,1587,348
19/12/2020 ,657948,102029,536260,19659,3068,145066,8112,5273,161519,13385,7751,3341,4265,145,20,1107,439,333,1899,772
20/12/2020 ,664930,103239,541811,19880,3087,146958,8057,5009,163111,13066,6982,1210,5551,221,19,1892,-55,-264,1592,-319
21/12/2020 ,671778,104809,546884,20085,3097,148308,8366,4806,164577,13172,6848,1570,5073,205,10,1350,309,-203,1466,106
22/12/2020 ,678125,105146,552722,20257,3115,149691,8620,4462,165888,13082,6347,337,5838,172,18,1383,254,-344,1311,-90
23/12/2020 ,685639,106528,558703,20408,3130,151122,8643,4947,167842,13590,7514,1382,5981,151,15,1431,23,485,1954,508
24/12/2020 ,692838,108269,563980,20589,3146,152491,8833,5305,169775,14138,7199,1741,5277,181,16,1369,190,358,1933,548
25/12/2020 ,700097,108946,570304,20847,3167,154242,8720,5742,171871,14462,7259,677,6324,258,21,1751,-113,437,2096,324
26/12/2020 ,706837,109150,576693,20994,3182,156798,9439,4510,173929,13949,6740,204,6389,147,15,2556,719,-1232,2058,-513
27/12/2020 ,713365,108452,583676,21237,3204,158615,9655,4452,175926,14107,6528,-698,6983,243,22,1817,216,-58,1997,158
28/12/2020 ,719219,107789,589978,21452,3226,159878,9919,4581,177604,14500,5854,-663,6302,215,22,1263,264,129,1678,393
29/12/2020 ,727122,108636,596783,21703,3246,161337,10018,5059,179660,15077,7903,847,6805,251,20,1459,99,478,2056,577
30/12/2020 ,735124,109439,603741,21944,3266,162911,9882,5654,181713,15536,8002,803,6958,241,20,1574,-136,595,2053,459
31/12/2020 ,743198,109963,611097,22138,3287,164881,9746,5821,183735,15567,8074,524,7356,194,21,1970,-136,167,2022,31
01/01/2021 ,751270,111005,617936,22329,3308,166512,10082,5789,185691,15871,8072,1042,6839,191,21,1631,336,-32,1956,304
02/01/2021 ,758473,110400,625518,22555,3334,168781,10872,4599,187586,15471,7203,-605,7582,226,26,2269,790,-1190,1895,-400
03/01/2021 ,765350,110679,631937,22734,3345,170510,10978,4410,189243,15388,6877,279,6419,179,11,1729,106,-189,1657,-83
04/01/2021 ,772103,110089,639103,22911,3369,173036,10371,4299,191075,14670,6753,-590,7166,177,24,2526,-607,-111,1832,-718
05/01/2021 ,779548,110693,645746,23109,3392,174131,10897,4479,192899,15376,7445,604,6643,198,23,1095,526,180,1824,706
06/01/2021 ,788402,112593,652513,23296,3410,175441,12196,4254,195301,16450,8854,1900,6767,187,18,1310,1299,-225,2402,1074
07/01/2021 ,797723,114766,659437,23520,3435,176882,12781,4601,197699,17382,9321,2173,6924,224,25,1441,585,347,2398,932
08/01/2021 ,808340,117704,666883,23753,3463,179562,13397,4236,200658,17633,10617,2938,7446,233,28,2680,616,-365,2959,251
09/01/2021 ,818386,120928,673511,23947,3485,181613,13076,5237,203411,18313,10046,3224,6628,194,22,2051,-321,1001,2753,680
10/01/2021 ,828026,122873,681024,24129,3517,184576,13166,4863,206122,18029,9640,1945,7513,182,32,2963,90,-374,2711,-284
11/01/2021 ,836718,123636,688739,24343,3551,187086,13541,4405,208583,17946,8692,763,7715,214,34,2510,375,-458,2461,-83
12/01/2021 ,846765,126313,695807,24645,3589,188675,14591,4397,211252,18988,10047,2677,7068,302,38,1589,1050,-8,2669,1042
13/01/2021 ,858043,129628,703464,24951,3634,191635,15009,4450,214728,19459,11278,3315,7657,306,45,2960,418,53,3476,471
14/01/2021 ,869600,133149,711205,25246,3675,193719,15852,4647,217893,20499,11557,3521,7741,295,41,2084,843,197,3165,1040
15/01/2021 ,882418,138238,718696,25484,3710,195924,15553,5247,220434,20800,12818,5089,7491,238,35,2205,-299,600,2541,301
16/01/2021 ,896642,143517,727358,25767,3745,198136,17524,4565,223970,22089,14224,5279,8662,283,35,2212,1971,-682,3536,1289
17/01/2021 ,907929,145482,736460,25987,3779,201907,16741,4938,227365,21679,11287,1965,9102,220,34,3771,-783,373,3395,-410
18/01/2021 ,917015,144798,745935,26282,3815,204711,16419,4781,229726,21200,9086,-684,9475,295,36,2804,-322,-157,2361,-479
19/01/2021 ,927380,146842,753948,26590,3836,209238,14604,4611,232289,19215,10365,2044,8013,308,21,4527,-1815,-170,2563,-1985
20/01/2021 ,939948,149388,763703,26857,3868,210983,16389,4835,236075,21224,12568,2546,9755,267,32,1745,1785,224,3786,2009
21/01/2021 ,951651,151658,772790,27203,3900,213570,16966,4790,239226,21756,11703,2270,9087,346,32,2587,577,-45,3151,532
22/01/2021 ,965283,156683,781147,27453,3940,215719,17752,5607,243018,23359,13632,5025,8357,250,40,2149,786,817,3792,1603
23/01/2021 ,977474,158751,791059,27664,3980,219287,18657,4379,246303,23036,12191,2068,9912,211,40,3568,905,-1228,3285,-323
24/01/2021 ,989262,162617,798810,27835,4024,221567,19554,4670,249815,24224,11788,3866,7751,171,44,2280,897,291,3512,1188
25/01/2021 ,999256,161636,809488,28132,4063,224071,19869,4263,252266,24132,9994,-981,10678,297,39,2504,315,-407,2451,-92
26/01/2021 ,1012350,163526,820356,28468,4108,227010,19432,4030,254580,23462,13094,1890,10868,336,45,2939,-437,-233,2314,-670
27/01/2021 ,1024298,164113,831330,28855,4134,229981,18528,3773,256416,22301,11948,587,10974,387,26,2971,-904,-257,1836,-1161
28/01/2021 ,1037993,166540,842122,29331,4185,232701,18473,3946,259305,22419,13695,2427,10792,476,51,2720,-55,173,2889,118
29/01/2021 ,1051795,170017,852260,29518,4224,235140,19381,4008,262753,23389,13802,3477,10138,187,39,2439,908,62,3448,970
30/01/2021 ,1066313,174083,862502,29728,4254,238395,20539,3056,266244,23595,14518,4066,10242,210,30,3255,1158,-952,3491,206
31/01/2021 ,1078314,175095,873221,29998,4267,242069,19272,4110,269718,23382,12001,1012,10719,270,13,3674,-1267,1054,3474,-213
01/02/2021 ,1089308,175349,883682,30277,4337,244202,19824,4969,273332,24793,10994,254,10461,279,70,2133,552,859,3614,1411
02/02/2021 ,1099687,172576,896530,30581,4379,248515,18925,4875,276694,23800,10379,-2773,12848,304,42,4313,-899,-94,3362,-993
03/02/2021 ,1111671,175236,905665,30770,4420,249810,21863,4168,280261,26031,11984,2660,9135,189,41,1295,2938,-707,3567,2231
04/02/2021 ,1123105,175068,917036,31001,4461,254155,20419,4858,283893,25277,11434,-168,11371,231,41,4345,-1444,690,3632,-754
05/02/2021 ,1134854,176672,926980,31202,4502,256702,21191,4838,287233,26029,11749,1604,9944,201,41,2547,772,-20,3340,752
06/02/2021 ,1147010,176433,939184,31393,4541,261027,19325,4719,289612,24044,12156,-239,12204,191,39,4325,-1866,-119,2379,-1985
07/02/2021 ,1157837,176291,949990,31556,4587,265369,17958,5911,293825,23869,10827,-142,10806,163,46,4342,-1367,1192,4213,-175
08/02/2021 ,1166079,171288,963028,31763,4631,268785,17766,5787,296969,23553,8242,-5003,13038,207,44,3416,-192,-124,3144,-316
09/02/2021 ,1174779,169351,973452,31976,4681,271573,18174,5978,300406,24152,8700,-1937,10424,213,50,2788,408,191,3437,599
10/02/2021 ,1183555,168416,982972,32167,4725,274817,16676,7497,303715,24173,8776,-935,9520,191,44,3244,-1498,1519,3309,21
11/02/2021 ,1191990,166492,993117,32381,4748,278822,14119,8540,306229,22659,8435,-1924,10145,214,23,4005,-2557,1043,2514,-1514
12/02/2021 ,1201859,165086,1004117,32656,4798,284579,10774,9888,310039,20662,9869,-1406,11000,275,50,5757,-3345,1348,3810,-1997
13/02/2021 ,1210703,161731,1016036,32936,4850,289189,9644,9374,313057,19018,8844,-3355,11919,280,52,4610,-1130,-514,3018,-1644
14/02/2021 ,1217468,159012,1025273,33183,4895,293538,9017,8103,315553,17120,6765,-2719,9237,247,45,4349,-627,-1271,2496,-1898
15/02/2021 ,1223930,158498,1032065,33367,4940,295623,8881,7988,317432,16869,6462,-514,6792,184,45,2085,-136,-115,1879,-251
16/02/2021 ,1233959,160689,1039674,33596,4987,297695,9042,7569,319293,16611,10029,2191,7609,229,47,2072,161,-419,1861,-258
17/02/2021 ,1243646,162182,1047676,33788,5026,299795,8467,7450,320738,15917,9687,1493,8002,192,39,2100,-575,-119,1445,-694
18/02/2021 ,1252685,160494,1058222,33969,5044,302451,7067,6549,321111,13616,9039,-1688,10546,181,18,2656,-1400,-901,373,-2301
19/02/2021 ,1263299,160142,1069005,34152,5081,304995,7323,5632,323031,12955,10614,-352,10783,183,37,2544,256,-917,1920,-661
20/02/2021 ,1271353,158197,1078840,34316,5121,307759,7165,5858,325903,13023,8054,-1945,9835,164,40,2764,-158,226,2872,68
21/02/2021 ,1278653,157088,1087076,34489,5172,310412,7137,5902,328623,13039,7300,-1109,8236,173,51,2653,-28,44,2720,16
22/02/2021 ,1288833,157148,1096994,34691,5206,312748,7528,5612,331094,13140,10180,60,9918,202,34,2336,391,-290,2471,101
23/02/2021 ,1298608,158604,1104990,35014,5248,314563,7126,4939,331876,12065,9775,1456,7996,323,42,1815,-402,-673,782,-1075
24/02/2021 ,1306141,158162,1112725,35254,5301,317003,6008,4346,332658,10354,7533,-442,7735,240,53,2440,-1118,-593,782,-1711
25/02/2021 ,1314634,157705,1121411,35518,5346,319326,5499,4068,334239,9567,8493,-457,8686,264,45,2323,-509,-278,1581,-787
26/02/2021 ,1322866,158408,1128672,35786,5385,321038,5560,3917,335900,9477,8232,703,7261,268,39,1712,61,-151,1661,-90
27/02/2021 ,1329074,157039,1136054,35981,5439,322285,5885,4028,337637,9913,6208,-1369,7382,195,54,1247,325,111,1737,436
28/02/2021 ,1334634,155765,1142703,36166,5478,323892,5940,4425,339735,10365,5560,-1274,6649,185,39,1607,55,397,2098,452
01/03/2021 ,1341314,153074,1151915,36325,5528,326509,5891,3865,341793,9756,6680,-2691,9212,159,50,2617,-49,-560,2058,-609
02/03/2021 ,1347026,149645,1160863,36518,5568,328526,5072,3205,342371,8277,5712,-3429,8948,193,40,2017,-819,-660,578,-1479
03/03/2021 ,1353834,147197,1169916,36721,5613,331016,3742,3437,343808,7179,6808,-2448,9053,203,45,2490,-1330,232,1437,-1098
04/03/2021 ,1361098,147845,1176356,36897,5657,332758,3940,3461,345816,7401,7264,648,6440,176,44,1742,198,24,2008,222
05/03/2021 ,1368093,148380,1182687,37026,5702,334100,4026,3147,346975,7173,6995,535,6331,129,45,1342,86,-314,1159,-228
06/03/2021 ,1373836,147172,1189510,37154,5748,335617,4228,2998,348591,7226,5743,-1208,6823,128,46,1517,202,-149,1616,53
07/03/2021 ,1379662,147740,1194656,37266,5790,337426,4194,3015,350425,7209,5826,568,5146,112,42,1809,-34,17,1834,-17
08/03/2021 ,1386556,145628,1203381,37547,5838,338931,4494,2945,352208,7439,6894,-2112,8725,281,48,1505,300,-70,1783,230
09/03/2021 ,1392945,144311,1210877,37757,5883,340587,3856,2749,353075,6605,6389,-1317,7496,210,45,1656,-638,-196,867,-834
10/03/2021 ,1398578,144213,1216433,37932,5923,341398,3691,3103,354115,6794,5633,-98,5556,175,40,811,-165,354,1040,189
11/03/2021 ,1403722,141070,1224603,38049,5943,342306,4253,3367,355869,7620,5144,-3143,8170,117,20,908,562,264,1754,826
12/03/2021 ,1410134,140451,1231454,38229,5969,343351,4670,3752,357742,8422,6412,-619,6851,180,26,1045,417,385,1873,802
13/03/2021 ,1414741,138942,1237470,38329,5991,345202,4226,3357,358776,7583,4607,-1509,6016,100,22,1851,-444,-395,1034,-839
14/03/2021 ,1419455,137912,1243117,38426,6026,347210,3443,3301,359980,6744,4714,-1030,5647,97,35,2008,-783,-56,1204,-839
15/03/2021 ,1425044,136524,1249947,38573,6038,349002,3485,3010,361535,6495,5589,-1388,6830,147,12,1792,42,-291,1555,-249
16/03/2021 ,1430458,134042,1257663,38753,6062,350561,2996,2751,362370,5747,5414,-2482,7716,180,24,1559,-489,-259,835,-748
17/03/2021 ,1437283,131695,1266673,38915,6077,351680,2907,3036,363700,5943,6825,-2347,9010,162,15,1119,-89,285,1330,196
18/03/2021 ,1443853,131753,1272958,39142,6100,352827,3273,3219,365419,6492,6570,58,6285,227,23,1147,366,183,1719,549
19/03/2021 ,1450132,131828,1278965,39339,6120,354036,3483,3368,367007,6851,6279,75,6007,197,20,1209,210,149,1588,359
20/03/2021 ,1455788,131616,1284725,39447,6143,355221,3894,3686,368944,7580,5656,-212,5760,108,23,1185,411,318,1937,729
21/03/2021 ,1460184,129844,1290790,39550,6160,357100,3859,3463,370582,7322,4396,-1772,6065,103,17,1879,-35,-223,1638,-258
22/03/2021 ,1465928,128250,1297967,39711,6179,358826,3775,3276,372056,7051,5744,-1594,7177,161,19,1726,-84,-187,1474,-271
23/03/2021 ,1471225,126439,1304921,39865,6206,360479,3107,3079,372871,6186,5297,-1811,6954,154,27,1653,-668,-197,815,-865
24/03/2021 ,1476452,123926,1312543,39983,6224,362248,2650,2639,373761,5289,5227,-2513,7622,118,18,1769,-457,-440,890,-897
25/03/2021 ,1482559,125279,1317199,40081,6241,362975,3222,3049,375487,6271,6107,1353,4656,98,17,727,572,410,1726,982
26/03/2021 ,1487541,124497,1322878,40166,6260,363599,3629,3380,376868,7009,4982,-782,5679,85,19,624,407,331,1381,738
27/03/2021 ,1492002,124517,1327121,40364,6281,364251,3932,3758,378222,7690,4461,20,4243,198,21,652,303,378,1354,681
28/03/2021 ,1496085,124236,1331400,40449,6304,365592,3966,3830,379692,7796,4083,-281,4279,85,23,1341,34,72,1470,106
29/03/2021 ,1501093,123694,1336818,40581,6324,366615,4034,3733,380706,7767,5008,-542,5418,132,20,1023,68,-97,1014,-29
30/03/2021 ,1505775,122326,1342695,40754,6327,367819,3419,3525,381090,6944,4682,-1368,5877,173,3,1204,-615,-208,384,-823
31/03/2021 ,1511712,122524,1348330,40858,6341,369007,3028,3679,382055,6707,5937,198,5635,104,14,1188,-391,154,965,-237
01/04/2021 ,1517854,121222,1355578,41054,6344,369929,3447,3672,383392,7119,6142,-1302,7248,196,3,922,419,-7,1337,412
02/04/2021 ,1523179,121011,1361017,41151,6351,371254,3433,3594,384632,7027,5325,-211,5439,97,7,1325,-14,-78,1240,-92
03/04/2021 ,1527524,120068,1366214,41242,6356,372494,3317,3563,385730,6880,4345,-943,5197,91,5,1240,-116,-31,1098,-147
04/04/2021 ,1534255,116709,1375877,41669,6360,373565,3149,3392,386466,6541,6731,-3359,9663,427,4,1071,-168,-171,736,-339
05/04/2021 ,1537967,114475,1381677,41815,6372,374542,2771,3304,386989,6075,3712,-2234,5800,146,12,977,-378,-88,523,-466
06/04/2021 ,1542516,114566,1385973,41977,6379,375080,2705,3312,387476,6017,4549,91,4296,162,7,538,-66,8,487,-58
07/04/2021 ,1547376,113570,1391742,42064,6391,375651,2814,3482,388338,6296,4860,-996,5769,87,12,571,109,170,862,279
08/04/2021 ,1552880,111271,1399382,42227,6410,376270,3244,3653,389577,6897,5504,-2299,7640,163,19,619,430,171,1239,601
09/04/2021 ,1558145,110118,1405679,42348,6424,376959,3506,3701,390590,7207,5265,-1153,6297,121,14,689,262,48,1013,310
10/04/2021 ,1562868,111137,1409288,42443,6435,377797,3716,3619,391567,7335,4723,1019,3609,95,11,838,210,-82,977,128
11/04/2021 ,1566995,109958,1414507,42530,6450,379210,3617,3321,392598,6938,4127,-1179,5219,87,15,1413,-99,-298,1031,-397
12/04/2021 ,1571824,109372,1419796,42656,6459,380560,3324,2947,393290,6271,4829,-586,5289,126,9,1350,-293,-374,692,-667
13/04/2021 ,1577526,108599,1426145,42782,6482,381449,3326,2861,394118,6187,5702,-773,6349,126,23,889,2,-86,828,-84
14/04/2021 ,1583182,108384,1431892,42906,6489,382091,3338,2861,394779,6199,5656,-215,5747,124,7,642,12,0,661,12
15/04/2021 ,1589359,108032,1438254,43073,6504,382617,3921,3067,396109,6988,6177,-352,6362,167,15,526,583,206,1330,789
16/04/2021 ,1594722,107297,1444229,43196,6513,383655,3607,3313,397088,6920,5363,-735,5975,123,9,1038,-314,246,979,-68
17/04/2021 ,1599763,106243,1450192,43328,6520,384652,3512,3441,398125,6953,5041,-1054,5963,132,7,997,-95,128,1037,33
18/04/2021 ,1604348,105859,1455065,43424,6536,385615,3313,3611,399075,6924,4585,-384,4873,96,16,963,-199,170,950,-29
19/04/2021 ,1609300,104319,1461414,43567,6558,386606,3218,3666,400048,6884,4952,-1540,6349,143,22,991,-95,55,973,-40
20/04/2021 ,1614849,102930,1468142,43777,6569,387507,2945,3487,400508,6432,5549,-1389,6728,210,11,901,-273,-179,460,-452
21/04/2021 ,1620569,101106,1475456,44007,6587,388083,2954,3486,401110,6440,5720,-1824,7314,230,18,576,9,-1,602,8
22/04/2021 ,1626812,101191,1481449,44172,6596,388735,3497,3548,402376,7045,6243,85,5993,165,9,652,543,62,1266,605
23/04/2021 ,1632248,100533,1487369,44346,6612,389445,3584,3619,403260,7203,5436,-658,5920,174,16,710,87,71,884,158
24/04/2021 ,1636792,99970,1492322,44500,6623,390334,3563,3647,404167,7210,4544,-563,4953,154,11,889,-21,28,907,7
25/04/2021 ,1641194,100474,1496126,44594,6645,391301,3399,3718,405063,7117,4402,504,3804,94,22,967,-164,71,896,-93
26/04/2021 ,1647138,100652,1501715,44770,6660,392595,3152,3405,405812,6557,5944,178,5589,176,15,1294,-247,-313,749,-560
27/04/2021 ,1651794,100256,1506599,44939,6679,393205,2999,3322,406205,6321,4656,-396,4884,169,19,610,-153,-83,393,-236
28/04/2021 ,1657035,100502,1511417,45116,6690,393814,2950,3390,406844,6340,5241,246,4818,177,11,609,-49,68,639,19
29/04/2021 ,1662868,100102,1517432,45334,6710,394403,3308,3410,407831,6718,5833,-400,6015,218,20,589,358,20,987,378
30/04/2021 ,1668368,100213,1522634,45521,6733,394939,3421,3527,408620,6948,5500,111,5202,187,23,536,113,117,789,230
01/05/2021 ,1672880,100250,1526978,45652,6747,395644,3533,3622,409546,7155,4512,37,4344,131,14,705,112,95,926,207
02/05/2021 ,1677274,100760,1530718,45796,6767,396594,3450,3589,410400,7039,4394,510,3740,144,20,950,-83,-33,854,-116
03/05/2021 ,1682004,100564,1535491,45949,6788,397349,3483,3537,411157,7020,4730,-196,4773,153,21,755,33,-52,757,-19
04/05/2021 ,1686373,99087,1541149,46137,6807,397955,3247,3564,411573,6811,4369,-1477,5658,188,19,606,-236,27,416,-209
05/05/2021 ,1691658,98217,1547092,46349,6830,398610,3240,3738,412418,6978,5285,-870,5943,212,23,655,-7,174,845,167
06/05/2021 ,1697305,98277,1552532,46496,6850,399224,3406,3843,413323,7249,5647,60,5440,147,20,614,166,105,905,271
07/05/2021 ,1703632,98546,1558423,46663,6872,399821,3485,3928,414106,7413,6327,269,5891,167,22,597,79,85,783,164
08/05/2021 ,1709762,99003,1563917,46842,6896,400403,3569,3970,414838,7539,6130,457,5494,179,24,582,84,42,732,126
09/05/2021 ,1713684,98395,1568277,47012,6911,401114,3648,3974,415647,7622,3922,-608,4360,170,15,711,79,4,809,83
10/05/2021 ,1718575,96742,1574615,47218,6933,401744,3723,3941,416341,7664,4891,-1653,6338,206,22,630,75,-33,694,42
11/05/2021 ,1723596,95924,1580207,47465,6952,402374,3490,3931,416747,7421,5021,-818,5592,247,19,630,-233,-10,406,-243
12/05/2021 ,1728204,95709,1584878,47617,6973,403039,3402,3989,417403,7391,4608,-215,4671,152,21,665,-88,58,656,-30
13/05/2021 ,1731652,94857,1589079,47716,6973,403630,3630,3955,418188,7585,3448,-852,4201,99,0,591,228,-34,785,194
14/05/2021 ,1734285,93576,1592886,47823,7003,404187,3502,4128,418820,7630,2633,-1281,3807,107,30,557,-128,173,632,45
15/05/2021 ,1736670,91636,1597067,47967,7066,404715,3288,3978,419047,7266,2385,-1940,4181,144,63,528,-214,-150,227,-364
16/05/2021 ,1739750,90800,1600857,48093,7082,404980,3189,3957,419208,7146,3080,-836,3790,126,16,265,-99,-21,161,-120
17/05/2021 ,1744045,89129,1606611,48305,7107,405229,3158,4135,419629,7293,4295,-1671,5754,212,25,249,-31,178,421,147
18/05/2021 ,1748230,87514,1612239,48477,7130,405357,3248,4185,419920,7433,4185,-1615,5628,172,23,128,90,50,291,140
19/05/2021 ,1753101,87829,1616603,48669,7149,405535,3366,4409,420459,7775,4871,315,4364,192,19,178,118,224,539,342
20/05/2021 ,1758898,88439,1621572,48887,7169,405714,3797,4674,421354,8471,5797,610,4969,218,20,179,431,265,895,696
21/05/2021 ,1764644,89429,1626142,49073,7184,405918,4142,4966,422210,9108,5746,990,4570,186,15,204,345,292,856,637
22/05/2021 ,1769940,91240,1629495,49205,7196,406300,4386,5260,423142,9646,5296,1811,3353,132,12,382,244,294,932,538
23/05/2021 ,1775220,92847,1633045,49328,7207,406669,4744,5389,424009,10133,5280,1607,3550,123,11,369,358,129,867,487
24/05/2021 ,1781127,93393,1638279,49455,7225,406987,5079,5537,424828,10616,5907,546,5234,127,18,318,335,148,819,483
25/05/2021 ,1786187,94486,1642074,49627,7239,407493,5017,5463,425212,10480,5060,1093,3795,172,14,506,-62,-74,384,-136
26/05/2021 ,1791221,96187,1645263,49771,7250,408019,4993,5567,425829,10560,5034,1701,3189,144,11,526,-24,104,617,80
27/05/2021 ,1797499,98405,1649187,49907,7271,408585,5280,5633,426769,10913,6278,2218,3924,136,21,566,287,66,940,353
28/05/2021 ,1803361,98704,1654557,50100,7288,409497,5161,5516,427462,10677,5862,299,5370,193,17,912,-119,-117,693,-236
29/05/2021 ,1809926,99690,1659974,50262,7296,410508,5004,5461,428269,10465,6565,986,5417,162,8,1011,-157,-55,807,-212
30/05/2021 ,1816041,101639,1663998,50404,7309,411495,5100,5429,429333,10529,6115,1949,4024,142,13,987,96,-32,1064,64
31/05/2021 ,1821703,102006,1669119,50578,7327,412074,5241,5417,430059,10658,5662,367,5121,174,18,579,141,-12,726,129
01/06/2021 ,1826527,101325,1674479,50723,7349,412593,5214,5422,430578,10636,4824,-681,5360,145,22,519,-27,5,519,-22
02/06/2021 ,1831773,100364,1680501,50908,7361,413179,5178,5461,431179,10639,5246,-961,6022,185,12,586,-36,39,601,3
03/06/2021 ,1837126,94438,1691593,51095,7381,413680,5402,5430,431893,10832,5353,-5926,11092,187,20,501,224,-31,714,193
04/06/2021 ,1843612,94773,1697543,51296,7402,414496,5414,5487,432799,10901,6486,335,5950,201,21,816,12,57,906,69
05/06/2021 ,1850206,96973,1701784,51449,7423,415317,5756,5620,434116,11376,6594,2200,4241,153,21,821,342,133,1317,475
06/06/2021 ,1856038,98455,1705971,51612,7438,416181,5966,5550,435135,11516,5832,1482,4187,163,15,864,210,-70,1019,140
07/06/2021 ,1863031,99663,1711565,51803,7457,416994,6261,5620,436332,11881,6993,1208,5594,191,19,813,295,70,1197,365
08/06/2021 ,1869325,99963,1717370,51992,7478,417997,6057,5555,437087,11612,6294,300,5805,189,21,1003,-204,-65,755,-269
09/06/2021 ,1877050,101635,1723253,52162,7499,419109,6120,5730,438458,11850,7725,1672,5883,170,21,1112,63,175,1371,238
10/06/2021 ,1885901,104614,1728914,52373,7523,420211,6991,5829,440554,12820,8851,2979,5661,211,24,1102,871,99,2096,970
11/06/2021 ,1894025,106315,1735144,52566,7543,421396,7750,6158,442847,13908,8124,1701,6230,193,20,1185,759,329,2293,1088
12/06/2021 ,1901490,108324,1740436,52730,7557,422121,8855,6769,445302,15624,7465,2009,5292,164,14,725,1105,611,2455,1716
13/06/2021 ,1911358,113388,1745091,52879,7571,423056,10034,7410,448071,17444,9868,5064,4655,149,14,935,1179,641,2769,1820
14/06/2021 ,1919547,115197,1751234,53116,7609,424088,11240,7856,450793,19096,8189,1809,6143,237,38,1032,1206,446,2722,1652
15/06/2021 ,1927708,116787,1757641,53280,7634,425417,11102,8142,452295,19244,8161,1590,6407,164,25,1329,-138,286,1502,148
16/06/2021 ,1937652,120306,1763870,53476,7665,426695,11555,8756,454671,20311,9944,3519,6229,196,31,1278,453,614,2376,1067
17/06/2021 ,1950276,125303,1771220,53753,7713,428764,13054,9284,458815,22338,12624,4997,7350,277,48,2069,1499,528,4144,2027
18/06/2021 ,1963266,130096,1779127,54043,7777,431264,14951,9560,463552,24511,12990,4793,7907,290,64,2500,1897,276,4737,2173
19/06/2021 ,1976172,135738,1786143,54291,7836,433499,16787,10325,468447,27112,12906,5642,7016,248,59,2235,1836,765,4895,2601
20/06/2021 ,1989909,142719,1792528,54662,7905,435982,19105,11037,474029,30142,13737,6981,6385,371,69,2483,2318,712,5582,3030
21/06/2021 ,2004445,147728,1801761,54956,7976,439007,20717,11343,479043,32060,14536,5009,9233,294,71,3025,1612,306,5014,1918
22/06/2021 ,2018113,152686,1810136,55291,8014,442059,21167,11024,482264,32191,13668,4958,8375,335,38,3052,450,-319,3221,131
23/06/2021 ,2033421,160524,1817303,55594,8057,443195,22868,12837,486957,35705,15308,7838,7167,303,43,1136,1701,1813,4693,3514
24/06/2021 ,2053995,171542,1826504,55949,8107,445718,26403,14234,494462,40637,20574,11018,9201,355,50,2523,3535,1397,7505,4932
25/06/2021 ,2072867,181435,1835061,56371,8177,448288,29325,15606,501396,44931,18872,9893,8557,422,70,2570,2922,1372,6934,4294
26/06/2021 ,2093962,194776,1842457,56729,8220,451013,33829,17605,510667,51434,21095,13341,7396,358,43,2725,4504,1999,9271,6503
27/06/2021 ,2115304,207685,1850481,57138,8269,454497,38464,18831,520061,57295,21342,12909,8024,409,49,3484,4635,1226,9394,5861
28/06/2021 ,2135998,218476,1859961,57561,8348,457935,42252,19874,528409,62126,20694,10791,9480,423,79,3438,3788,1043,8348,4831
29/06/2021 ,2156465,228835,1869606,58024,8426,461439,45504,20419,535788,65923,20467,10359,9645,463,78,3504,3252,545,7379,3797
30/06/2021 ,2178272,239368,1880413,58491,8486,464943,47829,22210,543468,70039,21807,10533,10807,467,60,3504,2325,1791,7680,4116
01/07/2021 ,2203108,253826,1890287,58995,8528,468461,49836,24184,551009,74020,24836,14458,9874,504,42,3518,2007,1974,7541,3981
02/07/2021 ,2228938,267539,1901865,59534,8547,473467,53014,25380,560408,78394,25830,13713,11578,539,19,5006,3178,1196,9399,4374
03/07/2021 ,2256851,281677,1915147,60027,8577,479150,54941,27442,570110,82383,27913,14138,13282,493,30,5683,1927,2062,9702,3989
04/07/2021 ,2284084,295228,1928274,60582,8652,484949,59307,27687,580595,86994,27233,13551,13127,555,75,5799,4366,245,10485,4611
05/07/2021 ,2313829,309999,1942690,61140,8779,491556,62873,28290,591498,91163,29745,14771,14416,558,127,6607,3566,603,10903,4169
06/07/2021 ,2345018,324597,1958553,61868,8861,497492,65448,29136,600937,94584,31189,14598,15863,728,82,5936,2575,846,9439,3421
07/07/2021 ,2379397,343101,1973388,62908,9042,501199,69644,30418,610303,100062,34379,18504,14835,1040,181,3707,4196,1282,9366,5478
08/07/2021 ,2417788,359455,1994573,63760,9110,512085,72361,29721,623277,102082,38391,16354,21185,852,68,10886,2717,-697,12974,2020
09/07/2021 ,2455912,367733,2023548,64631,9306,526941,73239,26903,636389,100142,38124,8278,28975,871,196,14856,878,-2818,13112,-1940
10/07/2021 ,2491006,373440,2052109,65457,9357,543867,71812,24273,649309,96085,35094,5707,28561,826,51,16926,-1427,-2630,12920,-4057
11/07/2021 ,2527203,376015,2084724,66464,9395,564437,68251,20359,662442,88610,36197,2575,32615,1007,38,20570,-3561,-3914,13133,-7475
12/07/2021 ,2567630,380797,2119478,67355,9462,584912,66581,16106,677061,82687,40427,4782,34754,891,67,20475,-1670,-4253,14619,-5923
13/07/2021 ,2615529,407709,2139601,68219,9541,589486,71848,18368,689243,90216,47899,26912,20123,864,79,4574,5267,2262,12182,7529
14/07/2021 ,2670046,443473,2157363,69210,9603,592556,78571,21180,701910,99751,54517,35764,17762,991,62,3070,6723,2812,12667,9535
15/07/2021 ,2726803,480199,2176412,70192,9743,595582,86298,22978,714601,109276,56757,36726,19049,982,140,3026,7727,1798,12691,9525
16/07/2021 ,2780803,504915,2204491,71397,9845,604033,88295,24843,727016,113138,54000,24716,28079,1205,102,8451,1997,1865,12415,3862
17/07/2021 ,2832755,527872,2232394,72489,9902,615640,87929,23713,737184,111642,51952,22957,27903,1092,57,11607,-366,-1130,10168,-1496
18/07/2021 ,2877476,542236,2261658,73582,10103,627481,86457,22271,746312,108728,44721,14364,29264,1093,201,11841,-1472,-1442,9128,-2914
19/07/2021 ,2911733,542938,2293875,74920,10345,640171,81275,19521,751312,100796,34257,702,32217,1338,242,12690,-5182,-2750,5000,-7932
20/07/2021 ,2950058,550192,2323666,76200,10610,652242,75776,18897,757525,94673,38325,7254,29791,1280,265,12071,-5499,-624,6213,-6123
21/07/2021 ,2983830,549694,2356553,77583,10692,662800,72115,17822,763429,89937,33772,-498,32887,1383,82,10558,-3661,-1075,5904,-4736
22/07/2021 ,3033339,561384,2392923,79032,10865,673424,68974,17224,770487,86198,49509,11690,36370,1449,173,10624,-3141,-598,7058,-3739
23/07/2021 ,3082410,569901,2431911,80598,11021,687864,62789,16846,778520,79635,49071,8517,38988,1566,156,14440,-6185,-378,8033,-6563
24/07/2021 ,3127826,574135,2471678,82013,11181,702477,56946,16276,786880,73222,45416,4234,39767,1415,160,14613,-5843,-570,8360,-6413
25/07/2021 ,3166505,573908,2509318,83279,11333,716838,48934,15168,792273,64102,38679,-227,37640,1266,152,14361,-8012,-1108,5393,-9120
26/07/2021 ,3194733,560275,2549692,84766,11436,731504,38271,13724,794935,51995,28228,-13633,40374,1487,103,14666,-10663,-1444,2662,-12107
27/07/2021 ,3239936,556281,2596820,86835,11606,746087,26961,13848,798502,40809,45203,-3994,47128,2069,170,14583,-11310,124,3567,-11186
28/07/2021 ,3287727,558392,2640676,88659,11688,757122,22332,12885,804027,35217,47791,2111,43856,1824,82,11035,-4629,-963,5525,-5592
29/07/2021 ,3331206,554484,2686170,90552,11844,768562,16676,10790,807872,27466,43479,-3908,45494,1893,156,11440,-5656,-2095,3845,-7751
30/07/2021 ,3372374,549343,2730720,92311,11952,779720,11264,8390,811326,19654,41168,-5141,44550,1759,108,11158,-5412,-2400,3454,-7812
31/07/2021 ,3409658,545447,2770092,94119,12135,784668,10134,7716,814653,17850,37284,-3896,39372,1808,183,4948,-1130,-674,3327,-1804
01/08/2021 ,3440396,535135,2809538,95723,12209,789261,9399,6485,817354,15884,30738,-10312,39446,1604,74,4593,-735,-1231,2701,-1966
02/08/2021 ,3462800,523164,2842345,97291,12363,791422,9202,5777,818764,14979,22404,-11971,32807,1568,154,2161,-197,-708,1410,-905
03/08/2021 ,3496700,524142,2873669,98889,12433,793928,8705,5299,820365,14004,33900,978,31324,1598,70,2506,-497,-478,1601,-975
04/08/2021 ,3532567,524011,2907920,100636,12514,796381,9535,4916,823346,14451,35867,-131,34251,1747,81,2453,830,-383,2981,447
05/08/2021 ,3568331,518310,2947646,102375,12629,799151,9458,4419,825657,13877,35764,-5701,39726,1739,115,2770,-77,-497,2311,-574
06/08/2021 ,3607863,507375,2996478,104010,12682,802373,8813,3974,827842,12787,39532,-10935,48832,1635,53,3222,-645,-445,2185,-1090
07/08/2021 ,3639616,497824,3036194,105598,12750,806924,6957,3219,829850,10176,31753,-9551,39716,1588,68,4551,-1856,-755,2008,-2611
08/08/2021 ,3666031,474233,3084702,107096,12770,808087,7567,3075,831499,10642,26415,-23591,48508,1498,20,1163,610,-144,1649,466
09/08/2021 ,3686740,448508,3129661,108571,12783,809087,7430,2926,832226,10356,20709,-25725,44959,1475,13,1000,-137,-149,727,-286
10/08/2021 ,3718821,437055,3171147,110619,12824,810308,7495,3024,833651,10519,32081,-11453,41486,2048,41,1221,65,98,1425,163
11/08/2021 ,3749446,426170,3211078,112198,12866,811642,7873,3228,835609,11101,30625,-10885,39931,1579,42,1334,378,204,1958,582
12/08/2021 ,3774155,412776,3247715,113664,12908,813898,7008,2873,836687,9881,24709,-13394,36637,1466,42,2256,-865,-355,1078,-1220
13/08/2021 ,3804943,400129,3289718,115096,12976,815468,6724,2729,837897,9453,30788,-12647,42003,1432,68,1570,-284,-144,1210,-428
14/08/2021 ,3833541,395577,3321598,116366,13005,816687,6748,2820,839260,9568,28598,-4552,31880,1270,29,1219,24,91,1363,115
15/08/2021 ,3854354,384807,3351959,117588,13022,817764,6755,2901,840442,9656,20813,-10770,30361,1222,17,1077,7,81,1182,88
16/08/2021 ,3871738,371021,3381884,118833,13050,818700,6290,2915,840955,9205,17384,-13786,29925,1245,28,936,-465,14,513,-451
17/08/2021 ,3892479,358357,3414109,120013,13074,819620,5955,2961,841610,8916,20741,-12664,32225,1180,24,920,-335,46,655,-289
18/08/2021 ,3908247,343203,3443903,121141,13087,820517,6006,3029,842639,9035,15768,-15154,29794,1128,13,897,51,68,1029,119
19/08/2021 ,3930300,334752,3472915,122633,13121,821451,5794,3004,843370,8798,22053,-8451,29012,1492,34,934,-212,-25,731,-237
20/08/2021 ,3950304,327286,3499037,123981,13132,822399,5721,3087,844339,8808,20004,-7466,26122,1348,11,948,-73,83,969,10
21/08/2021 ,3967048,319658,3522048,125342,13152,823314,5565,3199,845230,8764,16744,-7628,23011,1361,20,915,-156,112,891,-44
22/08/2021 ,3979456,306760,3546324,126372,13173,824227,5584,2947,845931,8531,12408,-12898,24276,1030,21,913,19,-252,701,-233
23/08/2021 ,3989060,290764,3571082,127214,13193,824958,5477,2788,846416,8265,9604,-15996,24758,842,20,731,-107,-159,485,-266
24/08/2021 ,4008166,273750,3606164,128252,13203,825573,5277,2847,846900,8124,19106,-17014,35082,1038,10,615,-200,59,484,-141
25/08/2021 ,4026837,257677,3639867,129293,13214,826302,5442,2731,847689,8173,18671,-16073,33703,1041,11,729,165,-116,789,49
26/08/2021 ,4043736,243588,3669966,130182,13216,827333,5110,2604,848263,7714,16899,-14089,30099,889,2,1031,-332,-127,574,-459
27/08/2021 ,4056354,236317,3689256,130781,13232,827674,5491,2504,848901,7995,12618,-7271,19290,599,16,341,381,-100,638,281
28/08/2021 ,4066404,227182,3707850,131372,13242,828125,5607,2395,849369,8002,10050,-9135,18594,591,10,451,116,-109,468,7
29/08/2021 ,4073831,217590,3724318,131923,13252,828838,5497,2256,849843,7753,7427,-9592,16468,551,10,713,-110,-139,474,-249
30/08/2021 ,4079267,203060,3743716,132491,13261,829668,5097,2158,850184,7255,5436,-14530,19398,568,9,830,-400,-98,341,-498
31/08/2021 ,4089801,196281,3760497,133023,13290,830197,4980,2116,850583,7096,10534,-6779,16781,532,29,529,-117,-42,399,-159
01/09/2021 ,4100138,189571,3776891,133676,13302,831293,4489,2172,851256,6661,10337,-6710,16394,653,12,1096,-491,56,673,-435
02/09/2021 ,4109093,176638,3798099,134356,13312,832130,4201,2043,851686,6244,8955,-12933,21208,680,10,837,-288,-129,430,-417
03/09/2021 ,4116890,168317,3813643,134930,13322,832952,3841,1914,852029,5755,7797,-8321,15544,574,10,822,-360,-129,343,-489
04/09/2021 ,4123617,160699,3827449,135469,13332,833437,3807,1813,852389,5620,6727,-7618,13806,539,10,485,-34,-101,360,-135
05/09/2021 ,4129020,155519,3837640,135861,13342,833765,3820,1765,852692,5585,5403,-5180,10191,392,10,328,13,-48,303,-35
06/09/2021 ,4133433,146271,3850689,136473,13359,834489,3417,1644,852909,5061,4413,-9248,13049,612,17,724,-403,-121,217,-524
07/09/2021 ,4140634,138630,3864848,137156,13372,835030,3172,1597,853171,4769,7201,-7641,14159,683,13,541,-245,-47,262,-292
08/09/2021 ,4147365,132823,3876760,137782,13386,835700,2977,1536,853599,4513,6731,-5807,11912,626,14,670,-195,-61,428,-256
09/09/2021 ,4153355,127829,3887410,138116,13399,836187,2843,1478,853907,4321,5990,-4994,10650,334,13,487,-134,-58,308,-192
10/09/2021 ,4158731,118534,3901766,138431,13411,836644,2659,1454,854168,4113,5376,-9295,14356,315,12,457,-184,-24,261,-208
11/09/2021 ,4163732,115679,3909352,138701,13431,837033,2554,1418,854436,3972,5001,-2855,7586,270,20,389,-105,-36,268,-141
12/09/2021 ,4167511,109869,3918753,138889,13437,837364,2539,1402,854742,3941,3779,-5810,9401,188,6,331,-15,-16,306,-31
13/09/2021 ,4170088,99696,3931227,139165,13443,837805,2454,1227,854929,3681,2577,-10173,12474,276,6,441,-85,-175,187,-260
14/09/2021 ,4174216,92328,3942473,139415,13445,838306,2268,1100,855119,3368,4128,-7368,11246,250,2,501,-186,-127,190,-313
15/09/2021 ,4178164,84963,3953519,139682,13455,838680,2223,1066,855424,3289,3948,-7365,11046,267,10,374,-45,-34,305,-79
16/09/2021 ,4181309,73238,3968152,139919,13464,839022,2092,1022,855600,3114,3145,-11725,14633,237,9,342,-131,-44,176,-175
17/09/2021 ,4185144,68942,3976064,140138,13469,839379,1958,1000,855806,2958,3835,-4296,7912,219,5,357,-134,-22,206,-156
18/09/2021 ,4188529,65066,3983140,140323,13475,839623,1934,974,856006,2908,3385,-3876,7076,185,6,244,-24,-26,200,-50
19/09/2021 ,4190763,60969,3989326,140468,13479,839803,1916,963,856161,2879,2234,-4097,6186,145,4,180,-18,-11,155,-29
20/09/2021 ,4192695,55936,3996125,140634,13482,840212,1694,864,856252,2558,1932,-5033,6799,166,3,409,-222,-99,91,-321
21/09/2021 ,4195958,52447,4002706,140805,13486,840525,1552,795,856358,2347,3263,-3489,6581,171,4,313,-142,-69,106,-211
22/09/2021 ,4198678,49662,4008062,140954,13490,840812,1509,774,856585,2283,2720,-2785,5356,149,4,287,-43,-21,227,-64
23/09/2021 ,4201559,47997,4012448,141114,13493,841065,1505,687,856750,2192,2881,-1665,4386,160,3,253,-4,-87,165,-91
24/09/2021 ,4204116,45803,4017055,141258,13497,841393,1409,632,856931,2041,2557,-2194,4607,144,4,328,-96,-55,181,-151
25/09/2021 ,4206253,44071,4020801,141381,13500,841592,1381,591,857064,1972,2137,-1732,3746,123,3,199,-28,-41,133,-69
26/09/2021 ,4208013,42769,4023777,141467,13503,841719,1403,607,857232,2010,1760,-1302,2976,86,3,127,22,16,168,38
27/09/2021 ,4209403,40270,4027548,141585,13507,841980,1296,552,857335,1848,1390,-2499,3771,118,4,261,-107,-55,103,-162
28/09/2021 ,4211460,38652,4031099,141709,13512,842141,1246,540,857439,1786,2057,-1618,3551,124,5,161,-50,-12,104,-62
29/09/2021 ,4213414,37412,4034176,141826,13516,842336,1230,534,857616,1764,1954,-1240,3077,117,4,195,-16,-6,177,-22
30/09/2021 ,4215104,36141,4037024,141939,13519,842541,1195,510,857765,1705,1690,-1271,2848,113,3,205,-35,-24,149,-59
01/10/2021 ,4216728,34867,4039835,142026,13524,842715,1173,504,857916,1677,1624,-1274,2811,87,5,174,-22,-6,151,-28
02/10/2021 ,4218142,33812,4042215,142115,13529,842842,1217,483,858071,1700,1414,-1055,2380,89,5,127,44,-21,155,23
03/10/2021 ,4219284,32876,4044235,142173,13534,842929,1235,500,858198,1735,1142,-936,2020,58,5,87,18,17,127,35
04/10/2021 ,4220206,31054,4046891,142261,13534,843091,1261,461,858347,1722,922,-1822,2656,88,0,162,26,-39,149,-13
05/10/2021 ,4221610,29823,4049449,142338,13538,843239,1198,444,858419,1642,1404,-1231,2558,77,4,148,-63,-17,72,-80
06/10/2021 ,4223094,28381,4052300,142413,13540,843414,1217,451,858622,1668,1484,-1442,2851,75,2,175,19,7,203,26
07/10/2021 ,4224487,27747,4054246,142494,13541,843529,1253,448,858771,1701,1393,-634,1946,81,1,115,36,-3,149,33
08/10/2021 ,4225871,25551,4057760,142560,13541,843738,1206,436,858921,1642,1384,-2196,3514,66,0,209,-47,-12,150,-59
09/10/2021 ,4227038,25159,4059267,142612,13543,843822,1229,427,859021,1656,1167,-392,1507,52,2,84,23,-9,100,14
10/10/2021 ,4227932,24430,4060851,142651,13547,843891,1285,438,859161,1723,894,-729,1584,39,4,69,56,11,140,67
11/10/2021 ,4228552,22541,4063295,142716,13549,844189,1078,386,859202,1464,620,-1889,2444,65,2,298,-207,-52,41,-259
12/10/2021 ,4229813,21625,4065425,142763,13550,844538,947,310,859345,1257,1261,-916,2130,47,1,349,-131,-76,143,-207
13/10/2021 ,4231046,20551,4067684,142811,13550,844742,972,359,859623,1331,1233,-1074,2259,48,0,204,25,49,278,74
14/10/2021 ,4232099,19852,4069399,142848,13550,844839,978,369,859736,1347,1053,-699,1715,37,0,97,6,10,113,16
15/10/2021 ,4233014,19318,4070807,142889,13550,844901,1030,379,859860,1409,915,-534,1408,41,0,62,52,10,124,62
16/10/2021 ,4234011,18746,4072332,142933,13551,845121,992,350,860014,1342,997,-572,1525,44,1,220,-38,-29,154,-67
17/10/2021 ,4234758,18388,4073418,142952,13551,845248,998,348,860145,1346,747,-358,1086,19,0,127,6,-2,131,4
18/10/2021 ,4235384,17374,4075011,142999,13552,845386,984,330,860252,1314,626,-1014,1593,47,1,138,-14,-18,107,-32
19/10/2021 ,4236287,16697,4076541,143049,13552,845508,967,331,860358,1298,903,-677,1530,50,0,122,-17,1,106,-16
20/10/2021 ,4237201,16376,4077748,143077,13552,845650,947,312,860461,1259,914,-321,1207,28,0,142,-20,-19,103,-39
21/10/2021 ,4237834,15594,4079120,143120,13553,845763,934,300,860550,1234,633,-782,1372,43,1,113,-13,-12,89,-25
22/10/2021 ,4238594,15090,4080351,143153,13553,845884,895,301,860633,1196,760,-504,1231,33,0,121,-39,1,83,-38
23/10/2021 ,4239396,14803,4081417,143176,13555,846056,846,292,860749,1138,802,-287,1066,23,2,172,-49,-9,116,-58
24/10/2021 ,4240019,14360,4082454,143205,13556,846185,852,287,860880,1139,623,-443,1037,29,1,129,6,-5,131,1
25/10/2021 ,4240479,13554,4083690,143235,13557,846352,774,279,860962,1053,460,-806,1236,30,1,167,-78,-8,82,-86
26/10/2021 ,4241090,12989,4084831,143270,13558,846525,660,256,860999,916,611,-565,1141,35,1,173,-114,-23,37,-137
27/10/2021 ,4241809,12735,4085775,143299,13559,846667,618,260,861104,878,719,-254,944,29,1,142,-42,4,105,-38
28/10/2021 ,4242532,12440,4086759,143333,13560,846749,670,256,861235,926,723,-295,984,34,1,82,52,-4,131,48
29/10/2021 ,4243215,12414,4087440,143361,13560,846799,713,259,861331,972,683,-26,681,28,0,50,43,3,96,46
30/10/2021 ,4243835,12309,4088138,143388,13561,846942,660,264,861427,924,620,-105,698,27,1,143,-53,5,96,-48
31/10/2021 ,4244358,12318,4088635,143405,13562,847021,686,271,861540,957,523,9,497,17,1,79,26,7,113,33
01/11/2021 ,4244761,11919,4089419,143423,13562,847066,722,273,861623,995,403,-399,784,18,0,45,36,2,83,38
02/11/2021 ,4245373,11629,4090287,143457,13562,847201,671,266,861700,937,612,-290,868,34,0,135,-51,-7,77,-58
03/11/2021 ,4246174,11592,4091101,143481,13563,847353,658,258,861832,916,801,-37,814,24,1,152,-13,-8,132,-21
04/11/2021 ,4246802,11364,4091938,143500,13564,847403,718,258,861943,976,628,-228,837,19,1,50,60,0,111,60
05/11/2021 ,4247320,11215,4092586,143519,13565,847438,802,256,862061,1058,518,-149,648,19,1,35,84,-2,118,82
06/11/2021 ,4247721,10979,4093208,143534,13566,847685,648,231,862130,879,401,-236,622,15,1,247,-154,-25,69,-179
07/11/2021 ,4248165,10825,4093795,143545,13566,847808,653,220,862247,873,444,-154,587,11,0,123,5,-11,117,-6
08/11/2021 ,4248409,9774,4095078,143557,13566,847885,627,198,862276,825,244,-1051,1283,12,0,77,-26,-22,29,-48
09/11/2021 ,4248843,9602,4095663,143578,13566,848034,577,193,862370,770,434,-172,585,21,0,149,-50,-5,94,-55
10/11/2021 ,4249323,9537,4096194,143592,13566,848093,608,198,862465,806,480,-65,531,14,0,59,31,5,95,36
11/11/2021 ,4249758,9486,4096664,143608,13567,848137,660,208,862572,868,435,-51,470,16,1,44,52,10,107,62
12/11/2021 ,4250157,9305,4097224,143628,13567,848311,578,187,862643,765,399,-181,560,20,0,174,-82,-21,71,-103
13/11/2021 ,4250516,9197,4097675,143644,13567,848419,534,177,862697,711,359,-108,451,16,0,108,-44,-10,54,-54
14/11/2021 ,4250855,9018,4098178,143659,13568,848527,514,180,862789,694,339,-179,503,15,1,108,-20,3,92,-17
15/11/2021 ,4251076,8522,4098884,143670,13569,848604,477,175,862825,652,221,-496,706,11,1,77,-37,-5,36,-42
16/11/2021 ,4251423,8339,4099399,143685,13569,848710,447,178,862904,625,347,-183,515,15,0,106,-30,3,79,-27
17/11/2021 ,4251945,8390,4099857,143698,13570,848871,397,196,863034,593,522,51,458,13,1,161,-50,18,130,-32
18/11/2021 ,4252345,8315,4100321,143709,13571,849007,344,212,863134,556,400,-75,464,11,1,136,-53,16,100,-37
19/11/2021 ,4252705,8154,4100837,143714,13573,849111,348,199,863231,547,360,-161,516,5,2,104,4,-13,97,-9
20/11/2021 ,4253098,8154,4101216,143728,13574,849265,297,209,863345,506,393,0,379,14,1,154,-51,10,114,-41
21/11/2021 ,4253412,8126,4101547,143739,13574,849386,296,200,863456,496,314,-28,331,11,0,121,-1,-9,111,-10
22/11/2021 ,4253598,7965,4101889,143744,13574,849448,278,182,863482,460,186,-161,342,5,0,62,-18,-18,26,-36
23/11/2021 ,4253992,7916,4102323,143753,13574,849491,303,183,863551,486,394,-49,434,9,0,43,25,1,69,26
24/11/2021 ,4254443,7977,4102700,143766,13575,849596,294,168,863633,462,451,61,377,13,1,105,-9,-15,82,-24
25/11/2021 ,4254815,8040,4102993,143782,13576,849638,274,199,863687,473,372,63,293,16,1,42,-20,31,54,11
26/11/2021 ,4255268,8093,4103379,143796,13576,849693,292,196,863757,488,453,53,386,14,0,55,18,-3,70,15
27/11/2021 ,4255672,8226,4103639,143807,13576,849779,252,204,863811,456,404,133,260,11,0,86,-40,8,54,-32
28/11/2021 ,4255936,8214,4103914,143808,13576,849831,272,183,863862,455,264,-12,275,1,0,52,20,-21,51,-1
29/11/2021 ,4256112,7960,4104333,143819,13576,849902,255,170,863903,425,176,-254,419,11,0,71,-17,-13,41,-30
30/11/2021 ,4256409,7922,4104657,143830,13576,849929,264,178,863947,442,297,-38,324,11,0,27,9,8,44,17
01/12/2021 ,4256687,7883,4104964,143840,13576,849979,282,180,864017,462,278,-39,307,10,0,50,18,2,70,20
02/12/2021 ,4256998,7796,4105352,143850,13576,850046,248,175,864045,423,311,-87,388,10,0,67,-34,-5,28,-39
03/12/2021 ,4257243,7705,4105680,143858,13577,850114,229,167,864087,396,245,-91,328,8,1,68,-19,-8,42,-27
04/12/2021 ,4257489,7632,4105994,143863,13578,850175,209,173,864135,382,246,-73,314,5,1,61,-20,6,48,-14
05/12/2021 ,4257685,7526,4106292,143867,13579,850228,210,161,864178,371,196,-106,298,4,1,53,1,-12,43,-11
06/12/2021 ,4257815,5642,4108297,143876,13581,850281,181,149,864192,330,130,-1884,2005,9,2,53,-29,-12,14,-41
07/12/2021 ,4258076,5466,4108717,143893,13582,850319,171,151,864223,322,261,-176,420,17,1,38,-10,2,31,-8
08/12/2021 ,4258340,5363,4109068,143909,13583,850364,170,147,864264,317,264,-103,351,16,1,45,-1,-4,41,-5
09/12/2021 ,4258560,5278,4109364,143918,13583,850439,153,125,864300,278,220,-85,296,9,0,75,-17,-22,36,-39
10/12/2021 ,4258752,5154,4109675,143923,13583,850475,144,124,864326,268,192,-124,311,5,0,36,-9,-1,26,-10
11/12/2021 ,4258980,5186,4109865,143929,13583,850517,132,126,864358,258,228,32,190,6,0,42,-12,2,32,-10
12/12/2021 ,4259143,5158,4110049,143936,13583,850557,128,122,864390,250,163,-28,184,7,0,40,-4,-4,32,-8
13/12/2021 ,4259249,4974,4110327,143948,13583,850595,111,117,864406,228,106,-184,278,12,0,38,-17,-5,16,-22
14/12/2021 ,4259439,4905,4110574,143960,13583,850621,103,119,864426,222,190,-69,247,12,0,26,-8,2,20,-6
15/12/2021 ,4259644,4864,4110811,143969,13583,850649,104,113,864449,217,205,-41,237,9,0,28,1,-6,23,-5
16/12/2021 ,4259857,4833,4111045,143979,13583,850685,108,113,864489,221,213,-31,234,10,0,36,4,0,40,4
17/12/2021 ,4260148,4912,4111250,143986,13583,850719,118,107,864527,225,291,79,205,7,0,34,10,-6,38,4
18/12/2021 ,4260380,4918,4111464,143998,13583,850751,136,131,864601,267,232,6,214,12,0,32,18,24,74,42
19/12/2021 ,4260544,4923,4111619,144002,13583,850797,140,124,864644,264,164,5,155,4,0,46,4,-7,43,-3
20/12/2021 ,4260677,4829,4111835,144013,13584,850817,150,131,864682,281,133,-94,216,11,1,20,10,7,38,17
21/12/2021 ,4260893,4829,4112040,144024,13584,850837,160,156,864737,316,216,0,205,11,0,20,10,25,55,35
22/12/2021 ,4261072,4746,4112292,144034,13584,850858,176,162,864780,338,179,-83,252,10,0,21,16,6,43,22
23/12/2021 ,4261208,4642,4112524,144042,13584,850910,157,145,864796,302,136,-104,232,8,0,52,-19,-17,16,-36
24/12/2021 ,4261412,4659,4112706,144047,13584,850939,168,174,864865,342,204,17,182,5,0,29,11,29,69,40
25/12/2021 ,4261667,4713,4112901,144053,13584,850984,170,207,864945,377,255,54,195,6,0,45,2,33,80,35
26/12/2021 ,4261759,4655,4113049,144055,13584,851008,176,224,864992,400,92,-58,148,2,0,24,6,17,47,23
27/12/2021 ,4261879,4496,4113320,144063,13584,851096,171,183,865034,354,120,-159,271,8,0,88,-5,-41,42,-46
28/12/2021 ,4262157,4614,4113472,144071,13585,851138,236,171,865130,407,278,118,152,8,1,42,65,-12,96,53
29/12/2021 ,4262351,4528,4113742,144081,13587,851167,238,165,865157,403,194,-86,270,10,2,29,2,-6,27,-4
30/12/2021 ,4262540,4311,4114141,144088,13587,851201,251,171,865210,422,189,-217,399,7,0,34,13,6,53,19
31/12/2021 ,4262720,4292,4114334,144094,13588,851222,295,192,865297,487,180,-19,193,6,1,21,44,21,87,65
01/01/2022 ,4262994,4399,4114499,144096,13588,851280,342,205,865415,547,274,107,165,2,0,58,47,13,118,60
02/01/2022 ,4263168,4382,4114689,144097,13588,851386,428,116,865518,544,174,-17,190,1,0,106,86,-89,103,-3
03/01/2022 ,4263433,4530,4114801,144102,13588,851408,554,140,865690,694,265,148,112,5,0,22,126,24,172,150
04/01/2022 ,4263732,4658,4114969,144105,13588,851449,627,141,865805,768,299,128,168,3,0,41,73,1,115,74
05/01/2022 ,4264136,4878,4115149,144109,13589,851520,787,168,866064,955,404,220,180,4,1,71,160,27,259,187
06/01/2022 ,4264669,5195,4115358,144116,13589,851572,956,214,866331,1170,533,317,209,7,0,52,169,46,267,215
07/01/2022 ,4265187,5494,4115572,144121,13589,851648,1173,221,866631,1394,518,299,214,5,0,76,217,7,300,224
08/01/2022 ,4265666,5792,4115747,144127,13589,851727,1336,257,866909,1593,479,298,175,6,0,79,163,36,278,199
09/01/2022 ,4266195,6108,4115958,144129,13589,851839,1575,299,867302,1874,529,316,211,2,0,112,239,42,393,281
10/01/2022 ,4266649,6311,4116202,144136,13589,851944,1807,322,867662,2129,454,203,244,7,0,105,232,23,360,255
11/01/2022 ,4267451,6659,4116648,144144,13590,852126,2081,402,868199,2483,802,348,446,8,1,182,274,80,537,354
12/01/2022 ,4268097,6985,4116962,144150,13590,852269,2246,506,868611,2752,646,326,314,6,0,143,165,104,412,269
13/01/2022 ,4268890,7388,4117347,144155,13590,852563,2353,583,869089,2936,793,403,385,5,0,294,107,77,478,184
14/01/2022 ,4269740,7877,4117700,144163,13591,852727,2656,669,869643,3325,850,489,353,8,1,164,303,86,554,389
15/01/2022 ,4270794,8463,4118164,144167,13591,853003,3011,758,870363,3769,1054,586,464,4,0,276,355,89,720,444
16/01/2022 ,4271649,8605,4118874,144170,13591,853522,3045,771,870929,3816,855,142,710,3,0,519,34,13,566,47
17/01/2022 ,4272421,8775,4119472,144174,13591,853987,3035,809,871422,3844,772,170,598,4,0,465,-10,38,493,28
18/01/2022 ,4273783,9564,4120036,144183,13591,854204,3316,981,872092,4297,1362,789,564,9,0,217,281,172,670,453
19/01/2022 ,4275528,10796,4120540,144192,13591,854589,3799,1125,873104,4924,1745,1232,504,9,0,385,483,144,1012,627
20/01/2022 ,4277644,12328,4121117,144199,13591,855026,4420,1222,874259,5642,2116,1532,577,7,0,437,621,97,1155,718
21/01/2022 ,4280248,14119,4121928,144201,13591,855676,5031,1445,875743,6476,2604,1791,811,2,0,650,611,223,1484,834
22/01/2022 ,4283453,16692,4122555,144206,13591,856137,6130,1710,877568,7840,3205,2573,627,5,0,461,1099,265,1825,1364
23/01/2022 ,4286378,18891,4123267,144220,13597,856653,7046,2011,879307,9057,2925,2199,712,14,6,516,916,301,1739,1217
24/01/2022 ,4289305,20867,4124211,144227,13597,857215,8246,2242,881300,10488,2927,1976,944,7,0,562,1200,231,1993,1431
25/01/2022 ,4294183,24856,4125080,144247,13606,857688,9475,2721,883490,12196,4878,3989,869,20,9,473,1229,479,2190,1708
26/01/2022 ,4301193,29277,4127662,144254,13612,859305,10850,3232,886999,14082,7010,4421,2582,7,6,1617,1375,511,3509,1886
27/01/2022 ,4309270,35704,4129305,144261,13615,861203,12341,3989,891148,16330,8077,6427,1643,7,3,1898,1491,757,4149,2248
28/01/2022 ,4319175,43574,4131333,144268,13617,862670,14710,4709,895706,19419,9905,7870,2028,7,2,1467,2369,720,4558,3089
29/01/2022 ,4330763,52555,4133923,144285,13627,864447,17852,5545,901471,23397,11588,8981,2590,17,10,1777,3142,836,5765,3978
30/01/2022 ,4343185,61718,4137164,144303,13639,866477,21629,6348,908093,27977,12422,9163,3241,18,12,2030,3777,803,6622,4580
31/01/2022 ,4353370,68596,4140454,144320,13666,867519,25361,6809,913355,32170,10185,6878,3290,17,27,1042,3732,461,5262,4193
01/02/2022 ,4369391,81349,4143694,144348,13678,869184,28863,8018,919743,36881,16021,12753,3240,28,12,1665,3502,1209,6388,4711
02/02/2022 ,4387286,94109,4148804,144373,13689,873212,33384,8590,928875,41974,17895,12760,5110,25,11,4028,4521,572,9132,5093
03/02/2022 ,4414483,115275,4154797,144411,13713,877579,38248,9652,939192,47900,27197,21166,5993,38,24,4367,4864,1062,10317,5926
04/02/2022 ,4446694,140254,4161987,144453,13738,883377,43722,11534,952371,55256,32211,24979,7190,42,25,5798,5474,1882,13179,7356
05/02/2022 ,4480423,163468,4172458,144497,13767,891571,46609,13198,965145,59807,33729,23214,10471,44,29,8194,2887,1664,12774,4551
06/02/2022 ,4516480,188899,4183027,144554,13794,899957,52594,14625,980970,67219,36057,25431,10569,57,27,8386,5985,1427,15825,7412
07/02/2022 ,4542601,206361,4191604,144636,13832,905285,59023,15512,993652,74535,26121,17462,8577,82,38,5328,6429,887,12682,7316
08/02/2022 ,4580093,233062,4202312,144719,13872,910435,62941,17221,1004469,80162,37492,26701,10708,83,40,5150,3918,1709,10817,5627
09/02/2022 ,4626936,265824,4216328,144784,13889,923652,63131,18150,1018822,81281,46843,32762,14016,65,17,13217,190,929,14353,1119
10/02/2022 ,4667554,288186,4234510,144858,13911,929100,67456,19445,1029912,86901,40618,22362,18182,74,22,5448,4325,1295,11090,5620
11/02/2022 ,4708043,312808,4250277,144958,13950,945079,61665,19925,1040619,81590,40489,24622,15767,100,39,15979,-5791,480,10707,-5311
12/02/2022 ,4763252,335340,4282847,145065,13989,960624,59225,19198,1053036,78423,55209,22532,32570,107,39,15545,-2440,-727,12417,-3167
13/02/2022 ,4807778,352839,4309763,145176,14032,975674,54602,18900,1063208,73502,44526,17499,26916,111,43,15050,-4623,-298,10172,-4921
14/02/2022 ,4844279,375857,4323101,145321,14085,975770,62755,20873,1073483,83628,36501,23018,13338,145,53,96,8153,1973,10275,10126
15/02/2022 ,4901328,406025,4349848,145455,14135,984861,63221,20748,1082965,83969,57049,30168,26747,134,50,9091,466,-125,9482,341
16/02/2022 ,4966046,445190,4375234,145622,14191,992213,67232,21717,1095353,88949,64718,39165,25386,167,56,7352,4011,969,12388,4980
17/02/2022 ,5030002,469868,4414306,145828,14255,1008870,60632,20132,1103889,80764,63956,24678,39072,206,64,16657,-6600,-1585,8536,-8185
18/02/2022 ,5089637,496383,4447210,146044,14301,1020564,68649,8564,1112078,77213,59635,26515,32904,216,46,11694,8017,-11568,8189,-3551
19/02/2022 ,5149021,520910,4481909,146202,14326,1031739,67464,8002,1121531,75466,59384,24527,34699,158,25,11175,-1185,-562,9453,-1747
20/02/2022 ,5197505,536358,4514782,146365,14358,1043718,63658,7933,1129667,71591,48484,15448,32873,163,32,11979,-3806,-69,8136,-3875
21/02/2022 ,5231923,530671,4554711,146541,14382,1055584,57957,7102,1135025,65059,34418,-5687,39929,176,24,11866,-5701,-831,5358,-6532
22/02/2022 ,5289414,549431,4593185,146798,14415,1064272,54492,7054,1140233,61546,57491,18760,38474,257,33,8688,-3465,-48,5208,-3513
23/02/2022 ,5350902,571522,4632355,147025,14466,1071054,55116,6892,1147528,62008,61488,22091,39170,227,51,6782,624,-162,7295,462
24/02/2022 ,5408328,586113,4674873,147342,14513,1082827,50250,6793,1154383,57043,57426,14591,42518,317,47,11773,-4866,-99,6855,-4965
25/02/2022 ,5457775,573955,4736234,147586,14555,1091226,46586,6540,1158907,53126,49447,-12158,61361,244,42,8399,-3664,-253,4524,-3917
26/02/2022 ,5504418,578535,4778039,147844,14585,1100117,42956,5924,1163582,48880,46643,4580,41805,258,30,8891,-3630,-616,4675,-4246
27/02/2022 ,5539394,573898,4817423,148073,14609,1109056,38294,5580,1167539,43874,34976,-4637,39384,229,24,8939,-4662,-344,3957,-5006
28/02/2022 ,5564448,554698,4861415,148335,14664,1120433,34301,5441,1174839,39742,25054,-19200,43992,262,55,11377,-3993,-139,7300,-4132
01/03/2022 ,5589176,539210,4901302,148664,14690,1126008,32698,5077,1178473,37775,24728,-15488,39887,329,26,5575,-1603,-364,3634,-1967
02/03/2022 ,5630096,536823,4944237,149036,14710,1129828,33246,4885,1182669,38131,40920,-2387,42935,372,20,3820,548,-192,4196,356
03/03/2022 ,5667355,531696,4986391,149268,14730,1137499,30582,4527,1187338,35109,37259,-5127,42154,232,20,7671,-2664,-358,4669,-3022
04/03/2022 ,5693702,517253,5026853,149596,14754,1143134,28620,4557,1191065,33177,26347,-14443,40462,328,24,5635,-1962,30,3727,-1932
05/03/2022 ,5723858,500418,5073522,149918,14779,1148415,26276,4654,1194124,30930,30156,-16835,46669,322,25,5281,-2344,97,3059,-2247
06/03/2022 ,5748725,475951,5122602,150172,14798,1152865,25515,4615,1197793,30130,24867,-24467,49080,254,19,4450,-761,-39,3669,-800
07/03/2022 ,5770105,448273,5171402,150430,14828,1156926,23985,4747,1200486,28732,21380,-27678,48800,258,30,4061,-1530,132,2693,-1398
08/03/2022 ,5800253,422892,5226530,150831,14852,1161139,23353,4711,1204055,28064,30148,-25381,55128,401,24,4213,-632,-36,3569,-668
09/03/2022 ,5826589,417219,5258235,151135,14863,1164852,23627,4585,1207927,28212,26336,-5673,31705,304,11,3713,274,-126,3872,148
10/03/2022 ,5847900,399852,5296634,151413,14881,1168549,23480,4563,1211473,28043,21311,-17367,38399,278,18,3697,-147,-22,3546,-169
11/03/2022 ,5864010,376461,5335846,151703,14896,1173761,21240,4124,1214021,25364,16110,-23391,39212,290,15,5212,-2240,-439,2548,-2679
12/03/2022 ,5878910,357380,5369579,151951,14921,1178124,19285,3796,1216126,23081,14900,-19081,33733,248,25,4363,-1955,-328,2105,-2283
13/03/2022 ,5890495,342896,5395433,152166,14955,1180576,18707,3762,1218000,22469,11585,-14484,25854,215,34,2452,-578,-34,1874,-612
14/03/2022 ,5900124,312958,5434729,152437,14988,1184667,16373,3279,1219307,19652,9629,-29938,39296,271,33,4091,-2334,-483,1307,-2817
15/03/2022 ,5914532,299443,5462344,152745,15019,1187307,15603,2949,1220878,18552,14408,-13515,27615,308,31,2640,-770,-330,1571,-1100
16/03/2022 ,5927550,279969,5494606,152975,15031,1189556,15095,2902,1222584,17997,13018,-19474,32262,230,12,2249,-508,-47,1706,-555
17/03/2022 ,5939082,262477,5523393,153212,15043,1193225,13384,2515,1224167,15899,11532,-17492,28787,237,12,3669,-1711,-387,1583,-2098
18/03/2022 ,5948610,245979,5549220,153411,15061,1196098,12052,2472,1225683,14524,9528,-16498,25827,199,18,2873,-1332,-43,1516,-1375
19/03/2022 ,5956561,229734,5573228,153599,15073,1198669,11111,2315,1227168,13426,7951,-16245,24008,188,12,2571,-941,-157,1485,-1098
20/03/2022 ,5962483,219688,5589057,153738,15087,1200920,10004,2324,1228335,12328,5922,-10046,15829,139,14,2251,-1107,9,1167,-1098
21/03/2022 ,5967182,203345,5609945,153892,15093,1202740,9084,2280,1229197,11364,4699,-16343,20888,154,6,1820,-920,-44,862,-964
22/03/2022 ,5974646,181555,5639029,154062,15102,1204167,8773,2167,1230209,10940,7464,-21790,29084,170,9,1427,-311,-113,1012,-424
23/03/2022 ,5981022,168563,5658238,154221,15106,1205353,8903,2082,1231444,10985,6376,-12992,19209,159,4,1186,130,-85,1235,45
24/03/2022 ,5986830,155977,5676510,154343,15111,1207258,8098,2044,1232511,10142,5808,-12586,18272,122,5,1905,-805,-38,1067,-843
25/03/2022 ,5991687,146004,5691220,154463,15116,1208909,7445,1931,1233401,9376,4857,-9973,14710,120,5,1651,-653,-113,890,-766
26/03/2022 ,5995876,139143,5702163,154570,15121,1210332,6938,1806,1234197,8744,4189,-6861,10943,107,5,1423,-507,-125,796,-632
27/03/2022 ,5998953,129621,5714662,154670,15126,1211717,6186,1762,1234791,7948,3077,-9522,12499,100,5,1385,-752,-44,594,-796
28/03/2022 ,6001751,122014,5724963,154774,15138,1213009,5653,1564,1235364,7217,2798,-7607,10301,104,12,1292,-533,-198,573,-731
29/03/2022 ,6005646,115709,5735055,154882,15148,1213901,5744,1313,1236106,7057,3895,-6305,10092,108,10,892,91,-251,742,-160
30/03/2022 ,6009486,111555,5742931,155000,15159,1214728,5907,1213,1237007,7120,3840,-4154,7876,118,11,827,163,-100,901,63
31/03/2022 ,6012818,106927,5750802,155089,15167,1216040,5437,1092,1237736,6529,3332,-4628,7871,89,8,1312,-470,-121,729,-591
01/04/2022 ,6015748,100746,5759838,155164,15175,1217108,5119,975,1238377,6094,2930,-6181,9036,75,8,1068,-318,-117,641,-435
02/04/2022 ,6018048,98171,5764636,155241,15183,1218121,4795,911,1239010,5706,2300,-2575,4798,77,8,1013,-324,-64,633,-388
03/04/2022 ,6019981,95990,5768703,155288,15190,1218930,4636,866,1239622,5502,1933,-2181,4067,47,7,809,-159,-45,612,-204
04/04/2022 ,6021642,90235,5776058,155349,15200,1219664,4436,810,1240110,5246,1661,-5755,7355,61,10,734,-200,-56,488,-256
05/04/2022 ,6023924,85204,5783299,155421,15205,1220235,4420,818,1240678,5238,2282,-5031,7241,72,5,571,-16,8,568,-8
06/04/2022 ,6026324,82146,5788714,155464,15207,1220769,4714,741,1241431,5455,2400,-3058,5415,43,2,534,294,-77,753,217
07/04/2022 ,6028413,78302,5794602,155509,15212,1221596,4609,688,1242105,5297,2089,-3844,5888,45,5,827,-105,-53,674,-158
08/04/2022 ,6030168,76568,5798044,155556,15214,1222380,4456,647,1242697,5103,1755,-1734,3442,47,2,784,-153,-41,592,-194
09/04/2022 ,6031636,74130,5801909,155597,15217,1223059,4267,604,1243147,4871,1468,-2438,3865,41,3,679,-189,-43,450,-232
10/04/2022 ,6032707,72679,5804402,155626,15220,1223655,4039,603,1243517,4642,1071,-1451,2493,29,3,596,-228,-1,370,-229
11/04/2022 ,6033903,69849,5808380,155674,15224,1224308,3755,542,1243829,4297,1196,-2830,3978,48,4,653,-284,-61,312,-345
12/04/2022 ,6035358,67975,5811666,155717,15229,1224805,3607,543,1244184,4150,1455,-1874,3286,43,5,497,-148,1,355,-147
13/04/2022 ,6036909,66475,5814688,155746,15232,1225348,3515,488,1244583,4003,1551,-1500,3022,29,3,543,-92,-55,399,-147
14/04/2022 ,6037742,64044,5817904,155794,15234,1226139,3127,455,1244955,3582,833,-2431,3216,48,2,791,-388,-33,372,-421
15/04/2022 ,6038664,62665,5820179,155820,15238,1226739,2837,451,1245265,3288,922,-1379,2275,26,4,600,-290,-4,310,-294
16/04/2022 ,6039266,60475,5822947,155844,15240,1227338,2469,411,1245458,2880,602,-2190,2768,24,2,599,-368,-40,193,-408
17/04/2022 ,6039873,58278,5825729,155866,15244,1227793,2205,411,1245653,2616,607,-2197,2782,22,4,455,-264,0,195,-264
18/04/2022 ,6040432,50969,5833560,155903,15250,1228205,1997,371,1245823,2368,559,-7309,7831,37,6,412,-208,-40,170,-248
19/04/2022 ,6041269,49022,5836310,155937,15252,1228519,1876,355,1246002,2231,837,-1947,2750,34,2,314,-121,-16,179,-137
20/04/2022 ,6042010,45091,5840945,155974,15254,1228783,1866,330,1246233,2196,741,-3931,4635,37,2,264,-10,-25,231,-35
21/04/2022 ,6042595,31219,5855361,156015,15258,1229206,1603,325,1246392,1928,585,-13872,14416,41,4,423,-263,-5,159,-268
22/04/2022 ,6043246,21037,5866169,156040,15261,1229616,1417,313,1246607,1730,651,-10182,10808,25,3,410,-186,-12,215,-198
23/04/2022 ,6043768,19450,5868251,156067,15264,1229971,1256,288,1246779,1544,522,-1587,2082,27,3,355,-161,-25,172,-186
24/04/2022 ,6044150,17631,5870419,156100,15265,1230220,1149,280,1246914,1429,382,-1819,2168,33,1,249,-107,-8,135,-115
25/04/2022 ,6044467,13251,5875083,156133,15266,1230368,1107,274,1247015,1381,317,-4380,4664,33,1,148,-42,-6,101,-48
26/04/2022 ,6045043,9739,5879141,156163,15268,1230600,1077,269,1247214,1346,576,-3512,4058,30,2,232,-30,-5,199,-35
27/04/2022 ,6045660,9142,5880319,156199,15271,1230742,1053,278,1247344,1331,617,-597,1178,36,3,142,-24,9,130,-15
28/04/2022 ,6046072,8365,5881490,156217,15272,1230989,951,245,1247457,1196,412,-777,1171,18,1,247,-102,-33,113,-135
29/04/2022 ,6046467,8165,5882062,156240,15273,1231171,923,216,1247583,1139,395,-200,572,23,1,182,-28,-29,126,-57
30/04/2022 ,6046796,7897,5882660,156257,15274,1231413,829,218,1247734,1047,329,-268,598,17,1,242,-94,2,151,-92
01/05/2022 ,6047040,7474,5883293,156273,15275,1231573,756,211,1247815,967,244,-423,633,16,1,160,-73,-7,81,-80
02/05/2022 ,6047208,7257,5883664,156287,15277,1231709,708,209,1247903,917,168,-217,371,14,2,136,-48,-2,88,-50
03/05/2022 ,6047315,6951,5884059,156305,15278,1231833,623,209,1247943,832,107,-306,395,18,1,124,-85,0,40,-85
04/05/2022 ,6047491,6845,5884325,156321,15280,1231950,587,188,1248005,775,176,-106,266,16,2,117,-36,-21,62,-57
05/05/2022 ,6047741,6631,5884770,156340,15281,1232106,510,194,1248091,704,250,-214,445,19,1,156,-77,6,86,-71
06/05/2022 ,6047986,6530,5885099,156357,15282,1232228,476,194,1248180,670,245,-101,329,17,1,122,-34,0,89,-34
07/05/2022 ,6048204,6427,5885406,156371,15283,1232328,438,193,1248242,631,218,-103,307,14,1,100,-38,-1,62,-39
08/05/2022 ,6048431,6192,5885858,156381,15284,1232444,408,184,1248320,592,227,-235,452,10,1,116,-30,-9,78,-39
09/05/2022 ,6048685,6078,5886211,156396,15285,1232527,419,191,1248422,610,254,-114,353,15,1,83,11,7,102,18
10/05/2022 ,6049141,5855,5886870,156416,15287,1232618,490,177,1248572,667,456,-223,659,20,2,91,71,-14,150,57
11/05/2022 ,6049541,5331,5887786,156424,15288,1232696,549,168,1248701,717,400,-524,916,8,1,78,59,-9,129,50
12/05/2022 ,6049876,4867,5888571,156438,15290,1232729,614,168,1248801,782,335,-464,785,14,2,33,65,0,100,65
13/05/2022 ,6050211,4938,5888825,156448,15291,1232772,664,175,1248902,839,335,71,254,10,1,43,50,7,101,57
14/05/2022 ,6050519,4825,5889241,156453,15292,1232867,676,181,1249016,857,308,-113,416,5,1,95,12,6,114,18
15/05/2022 ,6050776,4784,5889534,156458,15293,1232939,686,191,1249109,877,257,-41,293,5,1,72,10,10,93,20
16/05/2022 ,6050958,4697,5889797,156464,15293,1233010,701,175,1249179,876,182,-87,263,6,0,71,15,-16,70,-1
17/05/2022 ,6051205,3898,5890826,156481,15293,1233102,670,189,1249254,859,247,-799,1029,17,0,92,-31,14,75,-17
18/05/2022 ,6051532,3844,5891190,156498,15294,1233206,670,197,1249367,867,327,-54,364,17,1,104,0,8,113,8
19/05/2022 ,6051850,3766,5891574,156510,15294,1233387,589,187,1249457,776,318,-78,384,12,0,181,-81,-10,90,-91
20/05/2022 ,6052100,3715,5891872,156513,15294,1233494,564,187,1249539,751,250,-51,298,3,0,107,-25,0,82,-25
21/05/2022 ,6052363,3718,5892126,156519,15294,1233575,581,182,1249632,763,263,3,254,6,0,81,17,-5,93,12
22/05/2022 ,6052590,3657,5892411,156522,15296,1233664,594,188,1249742,782,227,-61,285,3,2,89,13,6,110,19
23/05/2022 ,6052764,2890,5893340,156534,15297,1233779,548,176,1249800,724,174,-767,929,12,1,115,-46,-12,58,-58
24/05/2022 ,6053109,2933,5893628,156548,15300,1233873,580,195,1249948,775,345,43,288,14,3,94,32,19,148,51
25/05/2022 ,6053424,3011,5893860,156553,15300,1233937,631,208,1250076,839,315,78,232,5,0,64,51,13,128,64
26/05/2022 ,6053670,3011,5894103,156556,15300,1234021,669,210,1250200,879,246,0,243,3,0,84,38,2,124,40
27/05/2022 ,6053894,2949,5894380,156565,15300,1234087,709,214,1250310,923,224,-62,277,9,0,66,40,4,110,44
28/05/2022 ,6054173,2972,5894628,156573,15300,1234180,723,211,1250414,934,279,23,248,8,0,93,14,-3,104,11
29/05/2022 ,6054415,2952,5894889,156574,15300,1234280,722,201,1250503,923,242,-20,261,1,0,100,-1,-10,89,-11
30/05/2022 ,6054633,2871,5895176,156586,15303,1234376,704,201,1250584,905,218,-81,287,12,3,96,-18,0,81,-18
31/05/2022 ,6054973,2959,5895423,156591,15303,1234487,729,197,1250716,926,340,88,247,5,0,111,25,-4,132,21
01/06/2022 ,6055341,3141,5895606,156594,15303,1234566,823,188,1250880,1011,368,182,183,3,0,79,94,-9,164,85
02/06/2022 ,6055645,3105,5895940,156600,15303,1234723,830,182,1251038,1012,304,-36,334,6,0,157,7,-6,158,1
03/06/2022 ,6056017,3123,5896290,156604,15303,1234863,850,195,1251211,1045,372,18,350,4,0,140,20,13,173,33
04/06/2022 ,6056412,3254,5896548,156610,15303,1234976,913,192,1251384,1105,395,131,258,6,0,113,63,-3,173,60
05/06/2022 ,6056800,3433,5896752,156615,15303,1235069,1011,196,1251579,1207,388,179,204,5,0,93,98,4,195,102
06/06/2022 ,6057142,3498,5897022,156622,15303,1235172,1064,187,1251726,1251,342,65,270,7,0,103,53,-9,147,44
07/06/2022 ,6057660,3664,5897372,156624,15303,1235274,1222,187,1251986,1409,518,166,350,2,0,102,158,0,260,158
08/06/2022 ,6058180,3922,5897630,156628,15303,1235370,1417,184,1252274,1601,520,258,258,4,0,96,195,-3,288,192
09/06/2022 ,6058736,4061,5898040,156635,15303,1235508,1548,191,1252550,1739,556,139,410,7,0,138,131,7,276,138
10/06/2022 ,6059363,4341,5898384,156638,15303,1235666,1715,199,1252883,1914,627,280,344,3,0,158,167,8,333,175
11/06/2022 ,6059937,4538,5898758,156641,15303,1235838,1852,204,1253197,2056,574,197,374,3,0,172,137,5,314,142
12/06/2022 ,6060488,4680,5899165,156643,15303,1236002,2000,214,1253519,2214,551,142,407,2,0,164,148,10,322,158
13/06/2022 ,6061079,4926,5899501,156652,15304,1236184,2179,200,1253867,2379,591,246,336,9,1,182,179,-14,348,165
14/06/2022 ,6062009,5298,5900049,156662,15304,1236374,2446,260,1254384,2706,930,372,548,10,0,190,267,60,517,327
15/06/2022 ,6063251,6007,5900574,156670,15304,1236528,2980,302,1255114,3282,1242,709,525,8,0,154,534,42,730,576
16/06/2022 ,6064424,6668,5901083,156673,15305,1236820,3346,339,1255810,3685,1173,661,509,3,1,292,366,37,696,403
17/06/2022 ,6065644,7326,5901639,156679,15305,1237109,3712,370,1256496,4082,1220,658,556,6,0,289,366,31,686,397
18/06/2022 ,6066908,8062,5902162,156684,15305,1237400,4122,402,1257229,4524,1264,736,523,5,0,291,410,32,733,442
19/06/2022 ,6068075,8594,5902794,156687,15308,1237676,4543,437,1257964,4980,1167,532,632,3,3,276,421,35,735,456




























































































































































































































































































































































































































































































































































































































































































































































































































